"filename", "language", "C++", "LaTeX", "Python", "comment", "blank", "total"
"/Users/shiyu./Desktop/CP-Code/AP325/1-1.cpp", "C++", 41, 0, 0, 2, 3, 46
"/Users/shiyu./Desktop/CP-Code/AP325/1-10.cpp", "C++", 58, 0, 0, 2, 4, 64
"/Users/shiyu./Desktop/CP-Code/AP325/1-11-.cpp", "C++", 63, 0, 0, 12, 13, 88
"/Users/shiyu./Desktop/CP-Code/AP325/1-11.cpp", "C++", 53, 0, 0, 5, 4, 62
"/Users/shiyu./Desktop/CP-Code/AP325/1-2.cpp", "C++", 48, 0, 0, 2, 3, 53
"/Users/shiyu./Desktop/CP-Code/AP325/1-3.cpp", "C++", 40, 0, 0, 3, 4, 47
"/Users/shiyu./Desktop/CP-Code/AP325/1-5.cpp", "C++", 34, 0, 0, 2, 4, 40
"/Users/shiyu./Desktop/CP-Code/AP325/1-7.cpp", "C++", 40, 0, 0, 2, 4, 46
"/Users/shiyu./Desktop/CP-Code/AP325/1-8.cpp", "C++", 39, 0, 0, 2, 4, 45
"/Users/shiyu./Desktop/CP-Code/AP325/2-1.cpp", "C++", 31, 0, 0, 1, 2, 34
"/Users/shiyu./Desktop/CP-Code/AP325/2-2+.cpp", "C++", 39, 0, 0, 2, 3, 44
"/Users/shiyu./Desktop/CP-Code/AP325/2-2.cpp", "C++", 36, 0, 0, 2, 2, 40
"/Users/shiyu./Desktop/CP-Code/AP325/2-3.cpp", "C++", 32, 0, 0, 1, 4, 37
"/Users/shiyu./Desktop/CP-Code/AP325/2-4.cpp", "C++", 37, 0, 0, 1, 5, 43
"/Users/shiyu./Desktop/CP-Code/AP325/2-5+.cpp", "C++", 45, 0, 0, 2, 5, 52
"/Users/shiyu./Desktop/CP-Code/AP325/2-5.cpp", "C++", 46, 0, 0, 2, 6, 54
"/Users/shiyu./Desktop/CP-Code/AP325/2-6.cpp", "C++", 37, 0, 0, 1, 2, 40
"/Users/shiyu./Desktop/CP-Code/APCS/2016-03/p1-b964.cpp", "C++", 32, 0, 0, 0, 2, 34
"/Users/shiyu./Desktop/CP-Code/APCS/2016-10/p1-c294.cpp", "C++", 14, 0, 0, 0, 1, 15
"/Users/shiyu./Desktop/CP-Code/APCS/2016-10/p2-c295.cpp", "C++", 38, 0, 0, 1, 2, 41
"/Users/shiyu./Desktop/CP-Code/APCS/2017-03/p1-c290.cpp", "C++", 26, 0, 0, 0, 2, 28
"/Users/shiyu./Desktop/CP-Code/APCS/2017-10/p1-c461.cpp", "C++", 15, 0, 0, 0, 1, 16
"/Users/shiyu./Desktop/CP-Code/APCS/2018-03/p3-f637.cpp", "C++", 30, 0, 0, 1, 5, 36
"/Users/shiyu./Desktop/CP-Code/APCS/2019-06/p1-e286.py", "Python", 0, 0, 22, 0, 5, 27
"/Users/shiyu./Desktop/CP-Code/APCS/2020-07/p1-f579.cpp", "C++", 24, 0, 0, 0, 2, 26
"/Users/shiyu./Desktop/CP-Code/APCS/2020-10/p1-f312.cpp", "C++", 20, 0, 0, 1, 1, 22
"/Users/shiyu./Desktop/CP-Code/APCS/2020-10/p2-f313.cpp", "C++", 56, 0, 0, 1, 1, 58
"/Users/shiyu./Desktop/CP-Code/APCS/2021-01/(undone)p2-f606.cpp", "C++", 16, 0, 0, 1, 3, 20
"/Users/shiyu./Desktop/CP-Code/APCS/2021-01/p1-f605.cpp", "C++", 28, 0, 0, 0, 0, 28
"/Users/shiyu./Desktop/CP-Code/APCS/2021-09/p1-g275.cpp", "C++", 21, 0, 0, 0, 1, 22
"/Users/shiyu./Desktop/CP-Code/APCS/2021-11/p1-g595.cpp", "C++", 18, 0, 0, 0, 1, 19
"/Users/shiyu./Desktop/CP-Code/APCS/2021-11/p1-g595.py", "Python", 0, 0, 12, 0, 0, 12
"/Users/shiyu./Desktop/CP-Code/APCS/2022-01/p1-h081.cpp", "C++", 20, 0, 0, 0, 1, 21
"/Users/shiyu./Desktop/CP-Code/APCS/2022-10/p1-i428.py", "Python", 0, 0, 10, 0, 0, 10
"/Users/shiyu./Desktop/CP-Code/APCS/2022-10/p2-j123-1.cpp", "C++", 84, 0, 0, 7, 12, 103
"/Users/shiyu./Desktop/CP-Code/APCS/2022-10/p2-j123.cpp", "C++", 31, 0, 0, 1, 4, 36
"/Users/shiyu./Desktop/CP-Code/APCS/2023-01/(undone)p3-607.cpp", "C++", 35, 0, 0, 1, 2, 38
"/Users/shiyu./Desktop/CP-Code/APCS/2023-01/p1-j605.cpp", "C++", 20, 0, 0, 0, 1, 21
"/Users/shiyu./Desktop/CP-Code/APCS/2023-01/p2-j606.cpp", "C++", 28, 0, 0, 0, 1, 29
"/Users/shiyu./Desktop/CP-Code/APCS/2023-06/p1-k731.cpp", "C++", 52, 0, 0, 0, 1, 53
"/Users/shiyu./Desktop/CP-Code/APCS/2023-06/p2-k732.cpp", "C++", 36, 0, 0, 0, 3, 39
"/Users/shiyu./Desktop/CP-Code/APCS/2023-10/P1-m370.cpp", "C++", 25, 0, 0, 0, 1, 26
"/Users/shiyu./Desktop/CP-Code/APCS/2023-10/P2-m371.cpp", "C++", 58, 0, 0, 2, 1, 61
"/Users/shiyu./Desktop/CP-Code/APCS/2023-10/P3-m372+.cpp", "C++", 67, 0, 0, 6, 6, 79
"/Users/shiyu./Desktop/CP-Code/APCS/2023-10/P3-m372.cpp", "C++", 69, 0, 0, 4, 6, 79
"/Users/shiyu./Desktop/CP-Code/APCS/2024-01/P1-m931.cpp", "C++", 23, 0, 0, 0, 1, 24
"/Users/shiyu./Desktop/CP-Code/APCS/2024-01/P2-m932.cpp", "C++", 40, 0, 0, 0, 4, 44
"/Users/shiyu./Desktop/CP-Code/APCS/2024-01/P3-m933.cpp", "C++", 65, 0, 0, 5, 6, 76
"/Users/shiyu./Desktop/CP-Code/APCS/2024-06/P1.cpp", "C++", 24, 0, 0, 0, 1, 25
"/Users/shiyu./Desktop/CP-Code/APCS/2024-06/P2.cpp", "C++", 19, 0, 0, 0, 1, 20
"/Users/shiyu./Desktop/CP-Code/APCS/2024-06/P3.cpp", "C++", 33, 0, 0, 0, 3, 36
"/Users/shiyu./Desktop/CP-Code/APCS/2024-06/P4.cpp(undone).cpp", "C++", 52, 0, 0, 3, 1, 56
"/Users/shiyu./Desktop/CP-Code/APCS/APCS_105_2.py", "Python", 0, 0, 35, 5, 0, 40
"/Users/shiyu./Desktop/CP-Code/APCSClass/1/a064.cpp", "C++", 31, 0, 0, 0, 3, 34
"/Users/shiyu./Desktop/CP-Code/APCSClass/1/a096.cpp", "C++", 44, 0, 0, 0, 3, 47
"/Users/shiyu./Desktop/CP-Code/APCSClass/1/a104.cpp", "C++", 27, 0, 0, 0, 1, 28
"/Users/shiyu./Desktop/CP-Code/APCSClass/2/a104.py", "Python", 0, 0, 7, 0, 0, 7
"/Users/shiyu./Desktop/CP-Code/APCSClass/2/a114.cpp", "C++", 40, 0, 0, 1, 3, 44
"/Users/shiyu./Desktop/CP-Code/APCSClass/2/a115.cpp", "C++", 56, 0, 0, 1, 4, 61
"/Users/shiyu./Desktop/CP-Code/APCSClass/2/a116.cpp", "C++", 60, 0, 0, 1, 7, 68
"/Users/shiyu./Desktop/CP-Code/APCSClass/3/a117.cpp", "C++", 41, 0, 0, 0, 4, 45
"/Users/shiyu./Desktop/CP-Code/APCSClass/3/a118.cpp", "C++", 31, 0, 0, 0, 1, 32
"/Users/shiyu./Desktop/CP-Code/APCSClass/3/a157.cpp", "C++", 30, 0, 0, 0, 2, 32
"/Users/shiyu./Desktop/CP-Code/APCSClass/3/a158.cpp", "C++", 25, 0, 0, 0, 3, 28
"/Users/shiyu./Desktop/CP-Code/APCSClass/3/a228.cpp", "C++", 33, 0, 0, 0, 2, 35
"/Users/shiyu./Desktop/CP-Code/APCSClass/4/a105.cpp", "C++", 51, 0, 0, 3, 2, 56
"/Users/shiyu./Desktop/CP-Code/APCSClass/4/a147.cpp", "C++", 14, 0, 0, 0, 2, 16
"/Users/shiyu./Desktop/CP-Code/APCSClass/4/a159.cpp", "C++", 46, 0, 0, 0, 2, 48
"/Users/shiyu./Desktop/CP-Code/AtCoder/#305/A.cpp", "C++", 16, 0, 0, 0, 1, 17
"/Users/shiyu./Desktop/CP-Code/AtCoder/#305/B.cpp", "C++", 19, 0, 0, 0, 1, 20
"/Users/shiyu./Desktop/CP-Code/AtCoder/#305/C.cpp", "C++", 42, 0, 0, 0, 1, 43
"/Users/shiyu./Desktop/CP-Code/AtCoder/#314/A.cpp", "C++", 39, 0, 0, 0, 4, 43
"/Users/shiyu./Desktop/CP-Code/AtCoder/#314/B.cpp", "C++", 73, 0, 0, 0, 3, 76
"/Users/shiyu./Desktop/CP-Code/AtCoder/#314/D.cpp", "C++", 62, 0, 0, 0, 4, 66
"/Users/shiyu./Desktop/CP-Code/AtCoder/#314/D2.cpp", "C++", 56, 0, 0, 1, 4, 61
"/Users/shiyu./Desktop/CP-Code/AtCoder/#318/pA.cpp", "C++", 38, 0, 0, 0, 3, 41
"/Users/shiyu./Desktop/CP-Code/AtCoder/#318/pB.cpp", "C++", 46, 0, 0, 0, 2, 48
"/Users/shiyu./Desktop/CP-Code/AtCoder/#318/pC.cpp", "C++", 43, 0, 0, 0, 2, 45
"/Users/shiyu./Desktop/CP-Code/AtCoder/#318/pE.cpp", "C++", 53, 0, 0, 0, 2, 55
"/Users/shiyu./Desktop/CP-Code/AtCoder/#335/pA.cpp", "C++", 17, 0, 0, 0, 2, 19
"/Users/shiyu./Desktop/CP-Code/AtCoder/#335/pB.cpp", "C++", 28, 0, 0, 0, 3, 31
"/Users/shiyu./Desktop/CP-Code/AtCoder/#335/pC.cpp", "C++", 38, 0, 0, 0, 4, 42
"/Users/shiyu./Desktop/CP-Code/AtCoder/#335/pD.cpp", "C++", 90, 0, 0, 11, 9, 110
"/Users/shiyu./Desktop/CP-Code/AtCoder/#336/pA.cpp", "C++", 49, 0, 0, 1, 4, 54
"/Users/shiyu./Desktop/CP-Code/AtCoder/#336/pB.cpp", "C++", 60, 0, 0, 1, 4, 65
"/Users/shiyu./Desktop/CP-Code/AtCoder/#336/pC.cpp", "C++", 58, 0, 0, 1, 3, 62
"/Users/shiyu./Desktop/CP-Code/AtCoder/#336/pE.cpp", "C++", 63, 0, 0, 1, 7, 71
"/Users/shiyu./Desktop/CP-Code/AtCoder/ABC-Basic/025-A.cpp", "C++", 26, 0, 0, 0, 2, 28
"/Users/shiyu./Desktop/CP-Code/AtCoder/ABC-Basic/047-B.cpp", "C++", 17, 0, 0, 0, 2, 19
"/Users/shiyu./Desktop/CP-Code/AtCoder/ABC-Basic/053-B.cpp", "C++", 37, 0, 0, 0, 2, 39
"/Users/shiyu./Desktop/CP-Code/AtCoder/ABC-Basic/057-C.cpp", "C++", 25, 0, 0, 0, 1, 26
"/Users/shiyu./Desktop/CP-Code/AtCoder/ABC-Basic/061-B.cpp", "C++", 20, 0, 0, 0, 1, 21
"/Users/shiyu./Desktop/CP-Code/AtCoder/ABC-Basic/064-A.cpp", "C++", 10, 0, 0, 0, 2, 12
"/Users/shiyu./Desktop/CP-Code/AtCoder/ABC-Basic/068-B.cpp", "C++", 14, 0, 0, 0, 1, 15
"/Users/shiyu./Desktop/CP-Code/AtCoder/ABC-Basic/069-B.cpp", "C++", 7, 0, 0, 0, 1, 8
"/Users/shiyu./Desktop/CP-Code/AtCoder/ABC-Basic/070-B.cpp", "C++", 9, 0, 0, 0, 2, 11
"/Users/shiyu./Desktop/CP-Code/AtCoder/ABC-Basic/071-B.cpp", "C++", 33, 0, 0, 0, 2, 35
"/Users/shiyu./Desktop/CP-Code/AtCoder/ABC-Basic/072-B.cpp", "C++", 24, 0, 0, 0, 2, 26
"/Users/shiyu./Desktop/CP-Code/AtCoder/ABC-Basic/081-A.cpp", "C++", 14, 0, 0, 0, 2, 16
"/Users/shiyu./Desktop/CP-Code/AtCoder/ABC-Basic/081-B.cpp", "C++", 29, 0, 0, 0, 2, 31
"/Users/shiyu./Desktop/CP-Code/AtCoder/ABC-Basic/083-B.cpp", "C++", 20, 0, 0, 0, 1, 21
"/Users/shiyu./Desktop/CP-Code/AtCoder/ABC-Basic/085-A.cpp", "C++", 20, 0, 0, 0, 2, 22
"/Users/shiyu./Desktop/CP-Code/AtCoder/ABC-Basic/086-A.cpp", "C++", 7, 0, 0, 0, 1, 8
"/Users/shiyu./Desktop/CP-Code/AtCoder/ABC-Basic/087-B.cpp", "C++", 22, 0, 0, 0, 2, 24
"/Users/shiyu./Desktop/CP-Code/AtCoder/ABC-Basic/088-A.cpp", "C++", 7, 0, 0, 0, 2, 9
"/Users/shiyu./Desktop/CP-Code/AtCoder/ABC-Basic/088-B.cpp", "C++", 30, 0, 0, 0, 1, 31
"/Users/shiyu./Desktop/CP-Code/AtCoder/ABC-Basic/088-C.cpp", "C++", 28, 0, 0, 0, 2, 30
"/Users/shiyu./Desktop/CP-Code/AtCoder/ABC-Basic/090-B.cpp", "C++", 32, 0, 0, 0, 1, 33
"/Users/shiyu./Desktop/CP-Code/AtCoder/ABC-Basic/095-A.cpp", "C++", 14, 0, 0, 0, 1, 15
"/Users/shiyu./Desktop/CP-Code/AtCoder/ABC-Basic/102-B.cpp", "C++", 17, 0, 0, 0, 1, 18
"/Users/shiyu./Desktop/CP-Code/AtCoder/ABC-Basic/105-B.cpp", "C++", 26, 0, 0, 0, 1, 27
"/Users/shiyu./Desktop/CP-Code/AtCoder/ABC-Basic/113-B.cpp", "C++", 21, 0, 0, 0, 1, 22
"/Users/shiyu./Desktop/CP-Code/AtCoder/ABC-Basic/144-B.cpp", "C++", 20, 0, 0, 0, 2, 22
"/Users/shiyu./Desktop/CP-Code/AtCoder/ABC-Basic/175-B.cpp", "C++", 30, 0, 0, 0, 2, 32
"/Users/shiyu./Desktop/CP-Code/AtCoder/ABC-Basic/200-A.cpp", "C++", 7, 0, 0, 0, 1, 8
"/Users/shiyu./Desktop/CP-Code/AtCoder/ABC-Basic/202-A.cpp", "C++", 7, 0, 0, 0, 1, 8
"/Users/shiyu./Desktop/CP-Code/AtCoder/ABC-Basic/202-B.cpp", "C++", 16, 0, 0, 0, 1, 17
"/Users/shiyu./Desktop/CP-Code/AtCoder/ABC-Basic/205-B.cpp", "C++", 24, 0, 0, 0, 1, 25
"/Users/shiyu./Desktop/CP-Code/AtCoder/ABC-Basic/207-A.cpp", "C++", 7, 0, 0, 0, 1, 8
"/Users/shiyu./Desktop/CP-Code/AtCoder/ABC-Basic/208-A.cpp", "C++", 7, 0, 0, 0, 1, 8
"/Users/shiyu./Desktop/CP-Code/AtCoder/ABC-Basic/209-A.cpp", "C++", 9, 0, 0, 0, 3, 12
"/Users/shiyu./Desktop/CP-Code/AtCoder/ABC-Basic/210-A.cpp", "C++", 9, 0, 0, 0, 3, 12
"/Users/shiyu./Desktop/CP-Code/AtCoder/ABC-Basic/212-A.cpp", "C++", 11, 0, 0, 0, 2, 13
"/Users/shiyu./Desktop/CP-Code/AtCoder/ABC-Basic/214-A.cpp", "C++", 9, 0, 0, 0, 1, 10
"/Users/shiyu./Desktop/CP-Code/AtCoder/ABC-Basic/214-B.cpp", "C++", 22, 0, 0, 0, 1, 23
"/Users/shiyu./Desktop/CP-Code/AtCoder/ABC-Basic/215-A.cpp", "C++", 9, 0, 0, 0, 1, 10
"/Users/shiyu./Desktop/CP-Code/AtCoder/ABC-Basic/216-b.cpp", "C++", 32, 0, 0, 1, 3, 36
"/Users/shiyu./Desktop/CP-Code/AtCoder/ABC-Basic/217-C.cpp", "C++", 14, 0, 0, 0, 1, 15
"/Users/shiyu./Desktop/CP-Code/AtCoder/ABC-Basic/218-B.cpp", "C++", 11, 0, 0, 0, 1, 12
"/Users/shiyu./Desktop/CP-Code/AtCoder/ABC-Basic/219-A.cpp", "C++", 10, 0, 0, 0, 1, 11
"/Users/shiyu./Desktop/CP-Code/AtCoder/ABC-Basic/219-B.cpp", "C++", 13, 0, 0, 0, 1, 14
"/Users/shiyu./Desktop/CP-Code/AtCoder/ABC-Basic/222-B.cpp", "C++", 13, 0, 0, 0, 1, 14
"/Users/shiyu./Desktop/CP-Code/AtCoder/ABC-Basic/223-A.cpp", "C++", 12, 0, 0, 0, 1, 13
"/Users/shiyu./Desktop/CP-Code/AtCoder/ABC-Basic/224-A.cpp", "C++", 20, 0, 0, 0, 2, 22
"/Users/shiyu./Desktop/CP-Code/AtCoder/ABC-Basic/224-B.cpp", "C++", 43, 0, 0, 0, 3, 46
"/Users/shiyu./Desktop/CP-Code/AtCoder/ABC-Basic/ARC002-1.cpp", "C++", 10, 0, 0, 0, 1, 11
"/Users/shiyu./Desktop/CP-Code/AtCoder/ABC-DSA/051-B.cpp", "C++", 28, 0, 0, 1, 3, 32
"/Users/shiyu./Desktop/CP-Code/AtCoder/ABC-DSA/067-B.cpp", "C++", 23, 0, 0, 1, 3, 27
"/Users/shiyu./Desktop/CP-Code/AtCoder/ABC-DSA/075-B.cpp", "C++", 41, 0, 0, 3, 5, 49
"/Users/shiyu./Desktop/CP-Code/AtCoder/ABC-DSA/085-C.cpp", "C++", 43, 0, 0, 1, 3, 47
"/Users/shiyu./Desktop/CP-Code/AtCoder/ABC-DSA/202-C.cpp", "C++", 49, 0, 0, 3, 6, 58
"/Users/shiyu./Desktop/CP-Code/AtCoder/ABC-DSA/212-C.cpp", "C++", 34, 0, 0, 26, 4, 64
"/Users/shiyu./Desktop/CP-Code/AtCoder/ABC-DSA/90問-014.cpp", "C++", 33, 0, 0, 0, 1, 34
"/Users/shiyu./Desktop/CP-Code/AtCoder/ABC-DSA/90問-016.cpp", "C++", 33, 0, 0, 1, 3, 37
"/Users/shiyu./Desktop/CP-Code/AtCoder/ABC-DSA/90問-069.cpp", "C++", 31, 0, 0, 1, 6, 38
"/Users/shiyu./Desktop/CP-Code/AtCoder/ABC-DSA/AGC013A.cpp", "C++", 49, 0, 0, 0, 1, 50
"/Users/shiyu./Desktop/CP-Code/AtCoder/ABC-DSA/AGC027-A.cpp", "C++", 32, 0, 0, 1, 3, 36
"/Users/shiyu./Desktop/CP-Code/AtCoder/ABC-DSA/ARC072-C.cpp", "C++", 79, 0, 0, 3, 4, 86
"/Users/shiyu./Desktop/CP-Code/AtCoder/ABC-DSA/ARC096-C.cpp", "C++", 30, 0, 0, 1, 3, 34
"/Users/shiyu./Desktop/CP-Code/CPE/2024-04/p1-a737.cpp", "C++", 37, 0, 0, 0, 1, 38
"/Users/shiyu./Desktop/CP-Code/CPE/2024-04/p2-c036.cpp", "C++", 50, 0, 0, 0, 1, 51
"/Users/shiyu./Desktop/CP-Code/CPE/2024-04/p3-e268.cpp", "C++", 46, 0, 0, 0, 1, 47
"/Users/shiyu./Desktop/CP-Code/CPE/2024-04/p4+.cpp", "C++", 31, 0, 0, 1, 2, 34
"/Users/shiyu./Desktop/CP-Code/CPE/2024-04/p4-n684.cpp", "C++", 30, 0, 0, 1, 3, 34
"/Users/shiyu./Desktop/CP-Code/CPE/2024-04/p5-d132.cpp", "C++", 70, 0, 0, 0, 3, 73
"/Users/shiyu./Desktop/CP-Code/CPE/2024-04/p6-a388.cpp", "C++", 37, 0, 0, 0, 2, 39
"/Users/shiyu./Desktop/CP-Code/CPE/2024-04/p7-a451.cpp", "C++", 47, 0, 0, 1, 3, 51
"/Users/shiyu./Desktop/CP-Code/CSES/Additional Problems/Stick Divisions.cpp", "C++", 34, 0, 0, 1, 3, 38
"/Users/shiyu./Desktop/CP-Code/CSES/Dynamic Programming/Coin Combinations I.cpp", "C++", 33, 0, 0, 0, 3, 36
"/Users/shiyu./Desktop/CP-Code/CSES/Dynamic Programming/Dice conbinations.cpp", "C++", 23, 0, 0, 0, 2, 25
"/Users/shiyu./Desktop/CP-Code/CSES/Graph Algorithm/Labyrinth.cpp", "C++", 62, 0, 0, 0, 5, 67
"/Users/shiyu./Desktop/CP-Code/CSES/Introductory Problems/(undone)Chessboard and Queens.cpp", "C++", 36, 0, 0, 1, 6, 43
"/Users/shiyu./Desktop/CP-Code/CSES/Introductory Problems/Apple Division.cpp", "C++", 31, 0, 0, 1, 2, 34
"/Users/shiyu./Desktop/CP-Code/CSES/Introductory Problems/Bit Strings.cpp", "C++", 17, 0, 0, 1, 3, 21
"/Users/shiyu./Desktop/CP-Code/CSES/Introductory Problems/Coin Piles.cpp", "C++", 16, 0, 0, 1, 2, 19
"/Users/shiyu./Desktop/CP-Code/CSES/Introductory Problems/Creating Strings.cpp", "C++", 17, 0, 0, 1, 2, 20
"/Users/shiyu./Desktop/CP-Code/CSES/Introductory Problems/Gray Code.cpp", "C++", 23, 0, 0, 1, 2, 26
"/Users/shiyu./Desktop/CP-Code/CSES/Introductory Problems/Increasing Array.cpp", "C++", 23, 0, 0, 1, 2, 26
"/Users/shiyu./Desktop/CP-Code/CSES/Introductory Problems/Missing Number.cpp", "C++", 19, 0, 0, 11, 2, 32
"/Users/shiyu./Desktop/CP-Code/CSES/Introductory Problems/Number Spiral.cpp", "C++", 17, 0, 0, 1, 2, 20
"/Users/shiyu./Desktop/CP-Code/CSES/Introductory Problems/Palindrome Reorder.cpp", "C++", 44, 0, 0, 1, 2, 47
"/Users/shiyu./Desktop/CP-Code/CSES/Introductory Problems/Permutations.cpp", "C++", 16, 0, 0, 1, 3, 20
"/Users/shiyu./Desktop/CP-Code/CSES/Introductory Problems/Repetitions.cpp", "C++", 28, 0, 0, 1, 2, 31
"/Users/shiyu./Desktop/CP-Code/CSES/Introductory Problems/Tower of Hanoi.cpp", "C++", 34, 0, 0, 1, 5, 40
"/Users/shiyu./Desktop/CP-Code/CSES/Introductory Problems/Trailing Zeros.cpp", "C++", 11, 0, 0, 1, 2, 14
"/Users/shiyu./Desktop/CP-Code/CSES/Introductory Problems/Two Knights.cpp", "C++", 18, 0, 0, 1, 3, 22
"/Users/shiyu./Desktop/CP-Code/CSES/Introductory Problems/Two Sets.cpp", "C++", 41, 0, 0, 1, 2, 44
"/Users/shiyu./Desktop/CP-Code/CSES/Introductory Problems/Two knights2.cpp", "C++", 8, 0, 0, 0, 1, 9
"/Users/shiyu./Desktop/CP-Code/CSES/Introductory Problems/Weird Algorithm.cpp", "C++", 16, 0, 0, 1, 2, 19
"/Users/shiyu./Desktop/CP-Code/CSES/Mathematics/Common Divisors.cpp", "C++", 36, 0, 0, 0, 2, 38
"/Users/shiyu./Desktop/CP-Code/CSES/Mathematics/Counting Divisors.cpp", "C++", 17, 0, 0, 1, 2, 20
"/Users/shiyu./Desktop/CP-Code/CSES/Mathematics/Exponentiation II.cpp", "C++", 38, 0, 0, 1, 4, 43
"/Users/shiyu./Desktop/CP-Code/CSES/Mathematics/Exponentiation.cpp", "C++", 38, 0, 0, 0, 3, 41
"/Users/shiyu./Desktop/CP-Code/CSES/Range Queries/Static Range Minimum Queries.cpp", "C++", 44, 0, 0, 1, 6, 51
"/Users/shiyu./Desktop/CP-Code/CSES/Range Queries/Static Range Sum Queries.cpp", "C++", 44, 0, 0, 0, 5, 49
"/Users/shiyu./Desktop/CP-Code/CSES/Sorting and Searching/Collecting Numbers.cpp", "C++", 22, 0, 0, 0, 1, 23
"/Users/shiyu./Desktop/CP-Code/CSES/Sorting and Searching/Distinct Numbers.cpp", "C++", 17, 0, 0, 0, 1, 18
"/Users/shiyu./Desktop/CP-Code/CSES/Sorting and Searching/Sum of Two Values.cpp", "C++", 40, 0, 0, 0, 1, 41
"/Users/shiyu./Desktop/CP-Code/CSES/Sorting and Searching/Tasks and Deadlines.cpp", "C++", 29, 0, 0, 1, 3, 33
"/Users/shiyu./Desktop/CP-Code/CodeForces/#849(Div.4)/a.py", "Python", 0, 0, 11, 0, 0, 11
"/Users/shiyu./Desktop/CP-Code/CodeForces/#849(Div.4)/b.py", "Python", 0, 0, 25, 0, 0, 25
"/Users/shiyu./Desktop/CP-Code/CodeForces/#849(Div.4)/c.py", "Python", 0, 0, 14, 0, 1, 15
"/Users/shiyu./Desktop/CP-Code/CodeForces/#849(Div.4)/d.py", "Python", 0, 0, 13, 0, 0, 13
"/Users/shiyu./Desktop/CP-Code/CodeForces/#855(Div.3)/a.cpp", "C++", 44, 0, 0, 1, 1, 46
"/Users/shiyu./Desktop/CP-Code/CodeForces/#859(Div.4)/a.cpp", "C++", 13, 0, 0, 0, 1, 14
"/Users/shiyu./Desktop/CP-Code/CodeForces/#859(Div.4)/b.cpp", "C++", 20, 0, 0, 0, 1, 21
"/Users/shiyu./Desktop/CP-Code/CodeForces/#859(Div.4)/c.cpp", "C++", 31, 0, 0, 0, 1, 32
"/Users/shiyu./Desktop/CP-Code/CodeForces/#859(Div.4)/d.cpp", "C++", 24, 0, 0, 0, 1, 25
"/Users/shiyu./Desktop/CP-Code/CodeForces/#859(Div.4)/e.cpp", "C++", 13, 0, 0, 0, 1, 14
"/Users/shiyu./Desktop/CP-Code/CodeForces/#859(Div.4)/f.cpp", "C++", 17, 0, 0, 0, 1, 18
"/Users/shiyu./Desktop/CP-Code/CodeForces/#881(Div.3)/A.cpp", "C++", 17, 0, 0, 0, 1, 18
"/Users/shiyu./Desktop/CP-Code/CodeForces/#881(Div.3)/B.cpp", "C++", 50, 0, 0, 5, 1, 56
"/Users/shiyu./Desktop/CP-Code/CodeForces/#886(Div.4)/A.cpp", "C++", 13, 0, 0, 0, 1, 14
"/Users/shiyu./Desktop/CP-Code/CodeForces/#886(Div.4)/B.cpp", "C++", 28, 0, 0, 0, 1, 29
"/Users/shiyu./Desktop/CP-Code/CodeForces/#886(Div.4)/C.cpp", "C++", 22, 0, 0, 0, 1, 23
"/Users/shiyu./Desktop/CP-Code/CodeForces/#886(Div.4)/D.cpp", "C++", 24, 0, 0, 0, 1, 25
"/Users/shiyu./Desktop/CP-Code/CodeForces/#886(Div.4)/E.cpp", "C++", 38, 0, 0, 1, 1, 40
"/Users/shiyu./Desktop/CP-Code/CodeForces/#891(Div.3)/A.cpp", "C++", 43, 0, 0, 0, 3, 46
"/Users/shiyu./Desktop/CP-Code/CodeForces/#891(Div.3)/B.cpp", "C++", 36, 0, 0, 0, 4, 40
"/Users/shiyu./Desktop/CP-Code/CodeForces/#891(Div.3)/C.cpp", "C++", 55, 0, 0, 34, 3, 92
"/Users/shiyu./Desktop/CP-Code/CodeForces/#894(Div.3)/pA.cpp", "C++", 63, 0, 0, 0, 3, 66
"/Users/shiyu./Desktop/CP-Code/CodeForces/#894(Div.3)/pB.cpp", "C++", 61, 0, 0, 0, 3, 64
"/Users/shiyu./Desktop/CP-Code/CodeForces/#894(Div.3)/pC.cpp", "C++", 72, 0, 0, 0, 5, 77
"/Users/shiyu./Desktop/CP-Code/CodeForces/#894(Div.3)/pD.cpp", "C++", 40, 0, 0, 0, 4, 44
"/Users/shiyu./Desktop/CP-Code/CodeForces/#895(Div.3)/pA.cpp", "C++", 46, 0, 0, 0, 4, 50
"/Users/shiyu./Desktop/CP-Code/CodeForces/#895(Div.3)/pB.cpp", "C++", 44, 0, 0, 0, 5, 49
"/Users/shiyu./Desktop/CP-Code/CodeForces/#898(Div.4)/pA.cpp", "C++", 28, 0, 0, 0, 2, 30
"/Users/shiyu./Desktop/CP-Code/CodeForces/#898(Div.4)/pB.cpp", "C++", 29, 0, 0, 0, 2, 31
"/Users/shiyu./Desktop/CP-Code/CodeForces/#898(Div.4)/pC.cpp", "C++", 39, 0, 0, 0, 2, 41
"/Users/shiyu./Desktop/CP-Code/CodeForces/#898(Div.4)/pD.cpp", "C++", 33, 0, 0, 0, 2, 35
"/Users/shiyu./Desktop/CP-Code/CodeForces/#898(Div.4)/pE.cpp", "C++", 56, 0, 0, 1, 3, 60
"/Users/shiyu./Desktop/CP-Code/CodeForces/#898(Div.4)/pG.cpp", "C++", 47, 0, 0, 0, 2, 49
"/Users/shiyu./Desktop/CP-Code/CodeForces/#900(Div.3)/pA.cpp", "C++", 23, 0, 0, 0, 1, 24
"/Users/shiyu./Desktop/CP-Code/CodeForces/#900(Div.3)/pB.cpp", "C++", 13, 0, 0, 0, 1, 14
"/Users/shiyu./Desktop/CP-Code/CodeForces/#900(Div.3)/pC.cpp", "C++", 18, 0, 0, 0, 2, 20
"/Users/shiyu./Desktop/CP-Code/CodeForces/#913(Div.3)/A.cpp", "C++", 56, 0, 0, 1, 3, 60
"/Users/shiyu./Desktop/CP-Code/CodeForces/#913(Div.3)/B.cpp", "C++", 79, 0, 0, 1, 3, 83
"/Users/shiyu./Desktop/CP-Code/CodeForces/#913(Div.3)/C.cpp", "C++", 76, 0, 0, 1, 4, 81
"/Users/shiyu./Desktop/CP-Code/CodeForces/#918(Div.4)/pA.cpp", "C++", 53, 0, 0, 1, 3, 57
"/Users/shiyu./Desktop/CP-Code/CodeForces/#918(Div.4)/pB.cpp", "C++", 60, 0, 0, 1, 3, 64
"/Users/shiyu./Desktop/CP-Code/CodeForces/#918(Div.4)/pC.cpp", "C++", 56, 0, 0, 1, 3, 60
"/Users/shiyu./Desktop/CP-Code/CodeForces/#918(Div.4)/pD.cpp", "C++", 70, 0, 0, 1, 4, 75
"/Users/shiyu./Desktop/CP-Code/CodeForces/#918(Div.4)/pE.cpp", "C++", 102, 0, 0, 2, 7, 111
"/Users/shiyu./Desktop/CP-Code/CodeForces/#919(Div.2)/pA.cpp", "C++", 66, 0, 0, 1, 4, 71
"/Users/shiyu./Desktop/CP-Code/CodeForces/#920(Div.3)/(undone)pD-2.cpp", "C++", 0, 0, 0, 1, 0, 1
"/Users/shiyu./Desktop/CP-Code/CodeForces/#920(Div.3)/pA.cpp", "C++", 58, 0, 0, 1, 3, 62
"/Users/shiyu./Desktop/CP-Code/CodeForces/#920(Div.3)/pB.cpp", "C++", 60, 0, 0, 1, 4, 65
"/Users/shiyu./Desktop/CP-Code/CodeForces/#920(Div.3)/pC.cpp", "C++", 61, 0, 0, 1, 5, 67
"/Users/shiyu./Desktop/CP-Code/CodeForces/#920(Div.3)/pD-1.cpp", "C++", 71, 0, 0, 1, 3, 75
"/Users/shiyu./Desktop/CP-Code/CodeForces/#920(Div.3)/pD.cpp", "C++", 68, 0, 0, 1, 6, 75
"/Users/shiyu./Desktop/CP-Code/CodeForces/#925(Div.3)/pA.cpp", "C++", 69, 0, 0, 2, 4, 75
"/Users/shiyu./Desktop/CP-Code/CodeForces/#925(Div.3)/pB.cpp", "C++", 84, 0, 0, 4, 5, 93
"/Users/shiyu./Desktop/CP-Code/CodeForces/#925(Div.3)/pC.cpp", "C++", 67, 0, 0, 2, 4, 73
"/Users/shiyu./Desktop/CP-Code/CodeForces/#925(Div.3)/pD.cpp", "C++", 60, 0, 0, 2, 4, 66
"/Users/shiyu./Desktop/CP-Code/CodeForces/#925(Div.3)/pE.cpp", "C++", 67, 0, 0, 2, 5, 74
"/Users/shiyu./Desktop/CP-Code/CodeForces/#927(Div.3)/pA.cpp", "C++", 65, 0, 0, 2, 4, 71
"/Users/shiyu./Desktop/CP-Code/CodeForces/#927(Div.3)/pB.cpp", "C++", 56, 0, 0, 2, 4, 62
"/Users/shiyu./Desktop/CP-Code/CodeForces/#927(Div.3)/pC-1.cpp", "C++", 86, 0, 0, 2, 4, 92
"/Users/shiyu./Desktop/CP-Code/CodeForces/#927(Div.3)/pC-2.cpp", "C++", 0, 0, 0, 1, 0, 1
"/Users/shiyu./Desktop/CP-Code/CodeForces/#927(Div.3)/pC.cpp", "C++", 75, 0, 0, 2, 4, 81
"/Users/shiyu./Desktop/CP-Code/CodeForces/#928(Div4)/pA.cpp", "C++", 57, 0, 0, 2, 4, 63
"/Users/shiyu./Desktop/CP-Code/CodeForces/#928(Div4)/pB.cpp", "C++", 69, 0, 0, 3, 4, 76
"/Users/shiyu./Desktop/CP-Code/CodeForces/#928(Div4)/pC.cpp", "C++", 48, 0, 0, 2, 5, 55
"/Users/shiyu./Desktop/CP-Code/CodeForces/#933(Div.3)/pA.cpp", "C++", 63, 0, 0, 2, 4, 69
"/Users/shiyu./Desktop/CP-Code/CodeForces/#933(Div.3)/pB.cpp", "C++", 68, 0, 0, 3, 4, 75
"/Users/shiyu./Desktop/CP-Code/CodeForces/#933(Div.3)/pC.cpp", "C++", 60, 0, 0, 2, 5, 67
"/Users/shiyu./Desktop/CP-Code/CodeForces/#933(Div.3)/pD.cpp", "C++", 91, 0, 0, 4, 7, 102
"/Users/shiyu./Desktop/CP-Code/CodeForces/#938(Div.3)/pA.cpp", "C++", 52, 0, 0, 2, 4, 58
"/Users/shiyu./Desktop/CP-Code/CodeForces/#938(Div.3)/pB-1.cpp", "C++", 77, 0, 0, 5, 4, 86
"/Users/shiyu./Desktop/CP-Code/CodeForces/#938(Div.3)/pB.cpp", "C++", 79, 0, 0, 7, 4, 90
"/Users/shiyu./Desktop/CP-Code/CodeForces/#938(Div.3)/pC-1.cpp", "C++", 97, 0, 0, 2, 4, 103
"/Users/shiyu./Desktop/CP-Code/CodeForces/#938(Div.3)/pC-2.cpp", "C++", 72, 0, 0, 3, 5, 80
"/Users/shiyu./Desktop/CP-Code/CodeForces/#938(Div.3)/pC.cpp", "C++", 77, 0, 0, 3, 4, 84
"/Users/shiyu./Desktop/CP-Code/CodeForces/#938(Div.3)/pD.cpp", "C++", 73, 0, 0, 2, 5, 80
"/Users/shiyu./Desktop/CP-Code/CodeForces/#940(Div.2)/pA.cpp", "C++", 58, 0, 0, 11, 3, 72
"/Users/shiyu./Desktop/CP-Code/CodeForces/#940(Div.2)/pB.cpp", "C++", 70, 0, 0, 11, 3, 84
"/Users/shiyu./Desktop/CP-Code/CodeForces/#940(Div.2)/pC.cpp", "C++", 69, 0, 0, 11, 3, 83
"/Users/shiyu./Desktop/CP-Code/CodeForces/#950(Div.3)/pA.cpp", "C++", 69, 0, 0, 11, 3, 83
"/Users/shiyu./Desktop/CP-Code/CodeForces/#950(Div.3)/pB.cpp", "C++", 82, 0, 0, 12, 4, 98
"/Users/shiyu./Desktop/CP-Code/CodeForces/#959(Div.1 + 2)/pA.cpp", "C++", 76, 0, 0, 11, 3, 90
"/Users/shiyu./Desktop/CP-Code/CodeForces/#959(Div.1 + 2)/pB.cpp", "C++", 75, 0, 0, 11, 3, 89
"/Users/shiyu./Desktop/CP-Code/CodeForces/#961(Div.2)/pA.cpp", "C++", 76, 0, 0, 11, 3, 90
"/Users/shiyu./Desktop/CP-Code/CodeForces/#961(Div.2)/pB.cpp", "C++", 95, 0, 0, 11, 3, 109
"/Users/shiyu./Desktop/CP-Code/CodeForces/#961(Div.2)/pC++.cpp", "C++", 86, 0, 0, 11, 4, 101
"/Users/shiyu./Desktop/CP-Code/CodeForces/#961(Div.2)/pC+.cpp", "C++", 116, 0, 0, 12, 7, 135
"/Users/shiyu./Desktop/CP-Code/CodeForces/#961(Div.2)/pC.cpp", "C++", 76, 0, 0, 11, 3, 90
"/Users/shiyu./Desktop/CP-Code/CodeForces/#962(Div.3)/pA.cpp", "C++", 61, 0, 0, 11, 3, 75
"/Users/shiyu./Desktop/CP-Code/CodeForces/#962(Div.3)/pB.cpp", "C++", 64, 0, 0, 12, 4, 80
"/Users/shiyu./Desktop/CP-Code/CodeForces/#962(Div.3)/pC+.cpp", "C++", 75, 0, 0, 13, 3, 91
"/Users/shiyu./Desktop/CP-Code/CodeForces/#962(Div.3)/pC.cpp", "C++", 72, 0, 0, 11, 3, 86
"/Users/shiyu./Desktop/CP-Code/CodeForces/EDU #166(Div.2)/pA.cpp", "C++", 60, 0, 0, 11, 3, 74
"/Users/shiyu./Desktop/CP-Code/CodeWars/2023/C.cpp", "C++", 63, 0, 0, 1, 4, 68
"/Users/shiyu./Desktop/CP-Code/CodeWars/2023/E.cpp", "C++", 51, 0, 0, 3, 2, 56
"/Users/shiyu./Desktop/CP-Code/CodeWars/2023/test.cpp", "C++", 11, 0, 0, 0, 1, 12
"/Users/shiyu./Desktop/CP-Code/CodeWars/刷 ZJ 歷屆/2010/a861.cpp", "C++", 10, 0, 0, 0, 1, 11
"/Users/shiyu./Desktop/CP-Code/CodeWars/刷 ZJ 歷屆/2010/a862.cpp", "C++", 10, 0, 0, 0, 1, 11
"/Users/shiyu./Desktop/CP-Code/CodeWars/刷 ZJ 歷屆/2010/a863.cpp", "C++", 28, 0, 0, 0, 1, 29
"/Users/shiyu./Desktop/CP-Code/CodeWars/刷 ZJ 歷屆/2010/a864.cpp", "C++", 20, 0, 0, 0, 2, 22
"/Users/shiyu./Desktop/CP-Code/CodeWars/刷 ZJ 歷屆/2010/a865.cpp", "C++", 26, 0, 0, 0, 2, 28
"/Users/shiyu./Desktop/CP-Code/CodeWars/刷 ZJ 歷屆/2019/e976.cpp", "C++", 12, 0, 0, 0, 1, 13
"/Users/shiyu./Desktop/CP-Code/CodeWars/刷 ZJ 歷屆/2021/1.cpp", "C++", 15, 0, 0, 0, 2, 17
"/Users/shiyu./Desktop/CP-Code/Elective APCS/0220(變數練習).cpp", "C++", 9, 0, 0, 0, 1, 10
"/Users/shiyu./Desktop/CP-Code/Elective APCS/0227(級數和函式).cpp", "C++", 31, 0, 0, 13, 4, 48
"/Users/shiyu./Desktop/CP-Code/Elective APCS/0306(解一元二次).cpp", "C++", 20, 0, 0, 10, 0, 30
"/Users/shiyu./Desktop/CP-Code/Elective APCS/0313(直線方程式).cpp", "C++", 54, 0, 0, 11, 4, 69
"/Users/shiyu./Desktop/CP-Code/Elective APCS/0325(for迴圈).cpp", "C++", 16, 0, 0, 7, 3, 26
"/Users/shiyu./Desktop/CP-Code/Elective APCS/0327(等差級數和).cpp", "C++", 12, 0, 0, 6, 2, 20
"/Users/shiyu./Desktop/CP-Code/Elective APCS/0410(數線等差位移次數).cpp", "C++", 18, 0, 0, 3, 0, 21
"/Users/shiyu./Desktop/CP-Code/Elective APCS/0417(字串).cpp", "C++", 16, 0, 0, 5, 0, 21
"/Users/shiyu./Desktop/CP-Code/Elective APCS/0501(階乘&排列&組合) copy.cpp", "C++", 41, 0, 0, 5, 3, 49
"/Users/shiyu./Desktop/CP-Code/Elective APCS/0515(BMI,匯率,溫度).cpp", "C++", 15, 0, 0, 5, 2, 22
"/Users/shiyu./Desktop/CP-Code/Elective APCS/0529(else if 稅金＆水費).cpp", "C++", 22, 0, 0, 5, 1, 28
"/Users/shiyu./Desktop/CP-Code/Elective APCS/0605(海龍公式).cpp", "C++", 25, 0, 0, 6, 1, 32
"/Users/shiyu./Desktop/CP-Code/Grade 10 Ranking CP/pA.cpp", "C++", 36, 0, 0, 1, 2, 39
"/Users/shiyu./Desktop/CP-Code/Grade 10 Ranking CP/pB-2.cpp", "C++", 47, 0, 0, 2, 6, 55
"/Users/shiyu./Desktop/CP-Code/Grade 10 Ranking CP/pB.cpp", "C++", 37, 0, 0, 0, 2, 39
"/Users/shiyu./Desktop/CP-Code/Grade 10 Ranking CP/pC.cpp", "C++", 32, 0, 0, 3, 2, 37
"/Users/shiyu./Desktop/CP-Code/Grade 10 Ranking CP/pD.cpp", "C++", 25, 0, 0, 0, 2, 27
"/Users/shiyu./Desktop/CP-Code/IONC/D1/pA.cpp", "C++", 57, 0, 0, 12, 3, 72
"/Users/shiyu./Desktop/CP-Code/IONC/D1/pC.cpp", "C++", 59, 0, 0, 0, 2, 61
"/Users/shiyu./Desktop/CP-Code/IONC/D1/pD.cpp", "C++", 53, 0, 0, 0, 4, 57
"/Users/shiyu./Desktop/CP-Code/IONC/D1/pE.cpp", "C++", 8, 0, 0, 0, 1, 9
"/Users/shiyu./Desktop/CP-Code/IONC/D1/pF.cpp", "C++", 26, 0, 0, 0, 1, 27
"/Users/shiyu./Desktop/CP-Code/IONC/D1/pG.cpp", "C++", 35, 0, 0, 0, 2, 37
"/Users/shiyu./Desktop/CP-Code/IONC/D2/pA.cpp", "C++", 38, 0, 0, 1, 0, 39
"/Users/shiyu./Desktop/CP-Code/IONC/D2/pB.cpp", "C++", 76, 0, 0, 1, 3, 80
"/Users/shiyu./Desktop/CP-Code/IONC/D2/pC.cpp", "C++", 40, 0, 0, 22, 5, 67
"/Users/shiyu./Desktop/CP-Code/IONC/D2/pD.cpp", "C++", 37, 0, 0, 0, 4, 41
"/Users/shiyu./Desktop/CP-Code/IONC/D2/pE.cpp", "C++", 61, 0, 0, 0, 2, 63
"/Users/shiyu./Desktop/CP-Code/IONC/D3/pB.cpp", "C++", 68, 0, 0, 1, 4, 73
"/Users/shiyu./Desktop/CP-Code/IONC/D3/pC.cpp", "C++", 36, 0, 0, 1, 4, 41
"/Users/shiyu./Desktop/CP-Code/IONC/D3/pD.cpp", "C++", 26, 0, 0, 1, 2, 29
"/Users/shiyu./Desktop/CP-Code/IONC/D3/pE.cpp", "C++", 50, 0, 0, 2, 5, 57
"/Users/shiyu./Desktop/CP-Code/IONC/D3/pG.cpp", "C++", 68, 0, 0, 1, 16, 85
"/Users/shiyu./Desktop/CP-Code/IONC/D3/pJ.cpp", "C++", 35, 0, 0, 4, 5, 44
"/Users/shiyu./Desktop/CP-Code/IONC/D4/pC+.cpp", "C++", 35, 0, 0, 7, 7, 49
"/Users/shiyu./Desktop/CP-Code/IONC/D4/pJ.cpp", "C++", 28, 0, 0, 0, 1, 29
"/Users/shiyu./Desktop/CP-Code/IONC/D4/pN++.cpp", "C++", 50, 0, 0, 10, 7, 67
"/Users/shiyu./Desktop/CP-Code/IONC/D4/pN+.cpp", "C++", 43, 0, 0, 2, 3, 48
"/Users/shiyu./Desktop/CP-Code/IONC/D4/pN.cpp", "C++", 48, 0, 0, 1, 3, 52
"/Users/shiyu./Desktop/CP-Code/ITSA/2023-10/pA.cpp", "C++", 38, 0, 0, 1, 1, 40
"/Users/shiyu./Desktop/CP-Code/Kattis/Basic/(unAC)Battle Simulation.cpp", "C++", 31, 0, 0, 0, 2, 33
"/Users/shiyu./Desktop/CP-Code/Kattis/Basic/(unAC)ImageProseccing.cpp", "C++", 16, 0, 0, 0, 3, 19
"/Users/shiyu./Desktop/CP-Code/Kattis/Basic/(undone)Pea Soup and Pancakes.cpp", "C++", 40, 0, 0, 3, 1, 44
"/Users/shiyu./Desktop/CP-Code/Kattis/Basic/Ameriskur vinnustour.cpp", "C++", 8, 0, 0, 0, 1, 9
"/Users/shiyu./Desktop/CP-Code/Kattis/Basic/Apaxiaaaaaaaaaaaans!.cpp", "C++", 25, 0, 0, 0, 2, 27
"/Users/shiyu./Desktop/CP-Code/Kattis/Basic/Architecture.cpp", "C++", 17, 0, 0, 0, 2, 19
"/Users/shiyu./Desktop/CP-Code/Kattis/Basic/Arm Coordination.cpp", "C++", 10, 0, 0, 0, 1, 11
"/Users/shiyu./Desktop/CP-Code/Kattis/Basic/Autori.cpp", "C++", 12, 0, 0, 0, 1, 13
"/Users/shiyu./Desktop/CP-Code/Kattis/Basic/Average Character.cpp", "C++", 10, 0, 0, 1, 0, 11
"/Users/shiyu./Desktop/CP-Code/Kattis/Basic/Baby Bites.cpp", "C++", 34, 0, 0, 0, 2, 36
"/Users/shiyu./Desktop/CP-Code/Kattis/Basic/Basketball one on one.cpp", "C++", 23, 0, 0, 0, 1, 24
"/Users/shiyu./Desktop/CP-Code/Kattis/Basic/Booking a Room.cpp", "C++", 32, 0, 0, 1, 1, 34
"/Users/shiyu./Desktop/CP-Code/Kattis/Basic/Broken Calculator.cpp", "C++", 21, 0, 0, 0, 1, 22
"/Users/shiyu./Desktop/CP-Code/Kattis/Basic/Building Pyramids.cpp", "C++", 14, 0, 0, 0, 1, 15
"/Users/shiyu./Desktop/CP-Code/Kattis/Basic/Bus Numbers2.cpp", "C++", 27, 0, 0, 0, 2, 29
"/Users/shiyu./Desktop/CP-Code/Kattis/Basic/Canadians, eh?.cpp", "C++", 20, 0, 0, 0, 2, 22
"/Users/shiyu./Desktop/CP-Code/Kattis/Basic/Card Trick.cpp", "C++", 35, 0, 0, 0, 1, 36
"/Users/shiyu./Desktop/CP-Code/Kattis/Basic/Cetvrta.cpp", "C++", 14, 0, 0, 0, 3, 17
"/Users/shiyu./Desktop/CP-Code/Kattis/Basic/Checkboard.cpp", "C++", 69, 0, 0, 42, 10, 121
"/Users/shiyu./Desktop/CP-Code/Kattis/Basic/Cinema Crowds 2.cpp", "C++", 14, 0, 0, 0, 1, 15
"/Users/shiyu./Desktop/CP-Code/Kattis/Basic/Cinema Crowds.cpp", "C++", 17, 0, 0, 0, 1, 18
"/Users/shiyu./Desktop/CP-Code/Kattis/Basic/Climbing worm.cpp", "C++", 15, 0, 0, 0, 1, 16
"/Users/shiyu./Desktop/CP-Code/Kattis/Basic/Cooking Water.cpp", "C++", 25, 0, 0, 0, 2, 27
"/Users/shiyu./Desktop/CP-Code/Kattis/Basic/Count the Vowels.cpp", "C++", 29, 0, 0, 0, 2, 31
"/Users/shiyu./Desktop/CP-Code/Kattis/Basic/Crne.cpp", "C++", 8, 0, 0, 0, 1, 9
"/Users/shiyu./Desktop/CP-Code/Kattis/Basic/Detailed Differences.cpp", "C++", 19, 0, 0, 0, 1, 20
"/Users/shiyu./Desktop/CP-Code/Kattis/Basic/Digit product.cpp", "C++", 20, 0, 0, 0, 1, 21
"/Users/shiyu./Desktop/CP-Code/Kattis/Basic/Distributing Poffins.cpp", "C++", 7, 0, 0, 0, 1, 8
"/Users/shiyu./Desktop/CP-Code/Kattis/Basic/Double Password.cpp", "C++", 12, 0, 0, 0, 1, 13
"/Users/shiyu./Desktop/CP-Code/Kattis/Basic/Early Winter.cpp", "C++", 18, 0, 0, 0, 1, 19
"/Users/shiyu./Desktop/CP-Code/Kattis/Basic/Echo Echo Echo.cpp", "C++", 8, 0, 0, 0, 1, 9
"/Users/shiyu./Desktop/CP-Code/Kattis/Basic/Espresso!.cpp", "C++", 34, 0, 0, 0, 2, 36
"/Users/shiyu./Desktop/CP-Code/Kattis/Basic/Event Planning.cpp", "C++", 27, 0, 0, 0, 4, 31
"/Users/shiyu./Desktop/CP-Code/Kattis/Basic/Eye of Sauron.cpp", "C++", 38, 0, 0, 0, 2, 40
"/Users/shiyu./Desktop/CP-Code/Kattis/Basic/FYI.cpp", "C++", 7, 0, 0, 0, 1, 8
"/Users/shiyu./Desktop/CP-Code/Kattis/Basic/Field Trip-1.cpp", "C++", 30, 0, 0, 1, 1, 32
"/Users/shiyu./Desktop/CP-Code/Kattis/Basic/Field Trip.cpp", "C++", 39, 0, 0, 0, 2, 41
"/Users/shiyu./Desktop/CP-Code/Kattis/Basic/Fifty shades of pink.cpp", "C++", 33, 0, 0, 0, 1, 34
"/Users/shiyu./Desktop/CP-Code/Kattis/Basic/FizzBuzz.cpp", "C++", 15, 0, 0, 0, 1, 16
"/Users/shiyu./Desktop/CP-Code/Kattis/Basic/FizzBuzz2.cpp", "C++", 44, 0, 0, 0, 2, 46
"/Users/shiyu./Desktop/CP-Code/Kattis/Basic/Flexible spaces.cpp", "C++", 26, 0, 0, 4, 1, 31
"/Users/shiyu./Desktop/CP-Code/Kattis/Basic/Flip Flow.cpp", "C++", 31, 0, 0, 0, 1, 32
"/Users/shiyu./Desktop/CP-Code/Kattis/Basic/Flow Layout.cpp", "C++", 34, 0, 0, 0, 1, 35
"/Users/shiyu./Desktop/CP-Code/Kattis/Basic/Forced Choice.cpp", "C++", 23, 0, 0, 0, 1, 24
"/Users/shiyu./Desktop/CP-Code/Kattis/Basic/Free food.cpp", "C++", 18, 0, 0, 0, 1, 19
"/Users/shiyu./Desktop/CP-Code/Kattis/Basic/Greedily Increasing Subsequence.cpp", "C++", 21, 0, 0, 0, 1, 22
"/Users/shiyu./Desktop/CP-Code/Kattis/Basic/Hailstones.cpp", "C++", 14, 0, 0, 0, 1, 15
"/Users/shiyu./Desktop/CP-Code/Kattis/Basic/Hangman.cpp", "C++", 35, 0, 0, 0, 2, 37
"/Users/shiyu./Desktop/CP-Code/Kattis/Basic/Head Guard.cpp", "C++", 34, 0, 0, 0, 2, 36
"/Users/shiyu./Desktop/CP-Code/Kattis/Basic/Hello World!.cpp", "C++", 6, 0, 0, 0, 1, 7
"/Users/shiyu./Desktop/CP-Code/Kattis/Basic/Hidden Password.cpp", "C++", 36, 0, 0, 0, 2, 38
"/Users/shiyu./Desktop/CP-Code/Kattis/Basic/Hissing Microphone.cpp", "C++", 16, 0, 0, 0, 1, 17
"/Users/shiyu./Desktop/CP-Code/Kattis/Basic/Honour thy parent.cpp", "C++", 20, 0, 0, 0, 1, 21
"/Users/shiyu./Desktop/CP-Code/Kattis/Basic/I've Been Everywhere, Man.cpp", "C++", 31, 0, 0, 0, 1, 32
"/Users/shiyu./Desktop/CP-Code/Kattis/Basic/Job expenses.cpp", "C++", 16, 0, 0, 0, 1, 17
"/Users/shiyu./Desktop/CP-Code/Kattis/Basic/Jolly jumpers.cpp", "C++", 33, 0, 0, 0, 1, 34
"/Users/shiyu./Desktop/CP-Code/Kattis/Basic/Jumbo javelin.cpp", "C++", 15, 0, 0, 0, 1, 16
"/Users/shiyu./Desktop/CP-Code/Kattis/Basic/Kemija.cpp", "C++", 31, 0, 0, 2, 1, 34
"/Users/shiyu./Desktop/CP-Code/Kattis/Basic/Last factorial digit.cpp", "C++", 14, 0, 0, 0, 1, 15
"/Users/shiyu./Desktop/CP-Code/Kattis/Basic/License to launch.cpp", "C++", 18, 0, 0, 0, 1, 19
"/Users/shiyu./Desktop/CP-Code/Kattis/Basic/Linden Mayor System.cpp", "C++", 39, 0, 0, 0, 2, 41
"/Users/shiyu./Desktop/CP-Code/Kattis/Basic/Line them up.cpp", "C++", 27, 0, 0, 0, 3, 30
"/Users/shiyu./Desktop/CP-Code/Kattis/Basic/Longest Prime Sum.cpp", "C++", 7, 0, 0, 0, 1, 8
"/Users/shiyu./Desktop/CP-Code/Kattis/Basic/Lost lineup.cpp", "C++", 14, 0, 0, 0, 1, 15
"/Users/shiyu./Desktop/CP-Code/Kattis/Basic/Magic Trick.cpp", "C++", 31, 0, 0, 0, 2, 33
"/Users/shiyu./Desktop/CP-Code/Kattis/Basic/Making A Meowth.cpp", "C++", 24, 0, 0, 0, 1, 25
"/Users/shiyu./Desktop/CP-Code/Kattis/Basic/Math homework.cpp", "C++", 25, 0, 0, 0, 1, 26
"/Users/shiyu./Desktop/CP-Code/Kattis/Basic/Moderate Pace.cpp", "C++", 25, 0, 0, 0, 1, 26
"/Users/shiyu./Desktop/CP-Code/Kattis/Basic/Mult!.cpp", "C++", 22, 0, 0, 0, 2, 24
"/Users/shiyu./Desktop/CP-Code/Kattis/Basic/No Duplicates.cpp", "C++", 28, 0, 0, 0, 1, 29
"/Users/shiyu./Desktop/CP-Code/Kattis/Basic/Odd Gnome.cpp", "C++", 25, 0, 0, 0, 1, 26
"/Users/shiyu./Desktop/CP-Code/Kattis/Basic/Overdraft.cpp", "C++", 18, 0, 0, 0, 1, 19
"/Users/shiyu./Desktop/CP-Code/Kattis/Basic/Paradox with averages.cpp", "C++", 32, 0, 0, 0, 3, 35
"/Users/shiyu./Desktop/CP-Code/Kattis/Basic/Permutation encryption.cpp", "C++", 29, 0, 0, 0, 1, 30
"/Users/shiyu./Desktop/CP-Code/Kattis/Basic/Pet.cpp", "C++", 17, 0, 0, 0, 1, 18
"/Users/shiyu./Desktop/CP-Code/Kattis/Basic/Poker hand.cpp", "C++", 24, 0, 0, 0, 1, 25
"/Users/shiyu./Desktop/CP-Code/Kattis/Basic/Polynomial Multiplication 1.cpp", "C++", 40, 0, 0, 0, 2, 42
"/Users/shiyu./Desktop/CP-Code/Kattis/Basic/Popular Vote.cpp", "C++", 31, 0, 0, 0, 1, 32
"/Users/shiyu./Desktop/CP-Code/Kattis/Basic/Prerequisites?.cpp", "C++", 51, 0, 0, 0, 3, 54
"/Users/shiyu./Desktop/CP-Code/Kattis/Basic/Prva.cpp", "C++", 42, 0, 0, 0, 1, 43
"/Users/shiyu./Desktop/CP-Code/Kattis/Basic/Putovanje.cpp", "C++", 27, 0, 0, 0, 1, 28
"/Users/shiyu./Desktop/CP-Code/Kattis/Basic/Quadrant Selection.cpp", "C++", 17, 0, 0, 0, 1, 18
"/Users/shiyu./Desktop/CP-Code/Kattis/Basic/Quick Brown Fox.cpp", "C++", 43, 0, 0, 0, 4, 47
"/Users/shiyu./Desktop/CP-Code/Kattis/Basic/Quick Estimates.cpp", "C++", 13, 0, 0, 1, 1, 15
"/Users/shiyu./Desktop/CP-Code/Kattis/Basic/Quite a problem.cpp", "C++", 25, 0, 0, 1, 1, 27
"/Users/shiyu./Desktop/CP-Code/Kattis/Basic/Ragged right.cpp", "C++", 19, 0, 0, 1, 1, 21
"/Users/shiyu./Desktop/CP-Code/Kattis/Basic/Reduced ID numbers.cpp", "C++", 35, 0, 0, 1, 1, 37
"/Users/shiyu./Desktop/CP-Code/Kattis/Basic/Relocation.cpp", "C++", 27, 0, 0, 0, 2, 29
"/Users/shiyu./Desktop/CP-Code/Kattis/Basic/Reverse.cpp", "C++", 10, 0, 0, 0, 1, 11
"/Users/shiyu./Desktop/CP-Code/Kattis/Basic/SMIL.cpp", "C++", 35, 0, 0, 0, 2, 37
"/Users/shiyu./Desktop/CP-Code/Kattis/Basic/Saving Princess Peach.cpp", "C++", 30, 0, 0, 0, 2, 32
"/Users/shiyu./Desktop/CP-Code/Kattis/Basic/SavingForRetirement.cpp", "C++", 7, 0, 0, 0, 1, 8
"/Users/shiyu./Desktop/CP-Code/Kattis/Basic/Shattered Cake.cpp", "C++", 14, 0, 0, 0, 1, 15
"/Users/shiyu./Desktop/CP-Code/Kattis/Basic/Sibice.cpp", "C++", 13, 0, 0, 0, 1, 14
"/Users/shiyu./Desktop/CP-Code/Kattis/Basic/Simon says.cpp", "C++", 20, 0, 0, 0, 1, 21
"/Users/shiyu./Desktop/CP-Code/Kattis/Basic/Smoothie Stand.cpp", "C++", 31, 0, 0, 1, 0, 32
"/Users/shiyu./Desktop/CP-Code/Kattis/Basic/Soda Slurper.cpp", "C++", 14, 0, 0, 0, 1, 15
"/Users/shiyu./Desktop/CP-Code/Kattis/Basic/Soylent.cpp", "C++", 11, 0, 0, 0, 1, 12
"/Users/shiyu./Desktop/CP-Code/Kattis/Basic/Statistics.cpp", "C++", 20, 0, 0, 0, 1, 21
"/Users/shiyu./Desktop/CP-Code/Kattis/Basic/Stopwatch.cpp", "C++", 18, 0, 0, 0, 1, 19
"/Users/shiyu./Desktop/CP-Code/Kattis/Basic/Stuck in a time loop.cpp", "C++", 12, 0, 0, 0, 1, 13
"/Users/shiyu./Desktop/CP-Code/Kattis/Basic/Thanos.cpp", "C++", 18, 0, 0, 0, 1, 19
"/Users/shiyu./Desktop/CP-Code/Kattis/Basic/The Calculus of Ada.cpp", "C++", 37, 0, 0, 4, 3, 44
"/Users/shiyu./Desktop/CP-Code/Kattis/Basic/The key to cryptography.cpp", "C++", 17, 0, 0, 0, 1, 18
"/Users/shiyu./Desktop/CP-Code/Kattis/Basic/Tower Construction.cpp", "C++", 14, 0, 0, 0, 1, 15
"/Users/shiyu./Desktop/CP-Code/Kattis/Basic/Trik.cpp", "C++", 16, 0, 0, 0, 1, 17
"/Users/shiyu./Desktop/CP-Code/Kattis/Basic/Two sum.cpp", "C++", 8, 0, 0, 0, 1, 9
"/Users/shiyu./Desktop/CP-Code/Kattis/Basic/Zamka.cpp", "C++", 39, 0, 0, 0, 3, 42
"/Users/shiyu./Desktop/CP-Code/Kattis/Basic/Zoom.cpp", "C++", 17, 0, 0, 0, 3, 20
"/Users/shiyu./Desktop/CP-Code/Kattis/Basic/Zyxab.cpp", "C++", 45, 0, 0, 0, 2, 47
"/Users/shiyu./Desktop/CP-Code/Kattis/Basic/hothike.cpp", "C++", 20, 0, 0, 0, 2, 22
"/Users/shiyu./Desktop/CP-Code/Kattis/Basic/jack o lantern juxtaposition.cpp", "C++", 8, 0, 0, 0, 1, 9
"/Users/shiyu./Desktop/CP-Code/Kattis/Basic/krizaljka.cpp", "C++", 32, 0, 0, 1, 2, 35
"/Users/shiyu./Desktop/CP-Code/Kattis/Basic/mirror.cpp", "C++", 19, 0, 0, 0, 1, 20
"/Users/shiyu./Desktop/CP-Code/Kattis/Basic/smart phone.cpp", "C++", 33, 0, 0, 3, 2, 38
"/Users/shiyu./Desktop/CP-Code/Kattis/DSA/(undone)Cyanide Rivers.cpp", "C++", 32, 0, 0, 1, 3, 36
"/Users/shiyu./Desktop/CP-Code/Kattis/DSA/(undone)Inflation.cpp", "C++", 39, 0, 0, 1, 3, 43
"/Users/shiyu./Desktop/CP-Code/Kattis/DSA/(undone)Paradox With Averages (Hard).cpp", "C++", 41, 0, 0, 1, 4, 46
"/Users/shiyu./Desktop/CP-Code/Kattis/DSA/A Prize No One Can Win.cpp", "C++", 28, 0, 0, 1, 3, 32
"/Users/shiyu./Desktop/CP-Code/Kattis/DSA/A new alphabet.cpp", "C++", 15, 0, 0, 1, 0, 16
"/Users/shiyu./Desktop/CP-Code/Kattis/DSA/Akcija.cpp", "C++", 33, 0, 0, 0, 1, 34
"/Users/shiyu./Desktop/CP-Code/Kattis/DSA/Astrological Sign.cpp", "C++", 35, 0, 0, 1, 4, 40
"/Users/shiyu./Desktop/CP-Code/Kattis/DSA/Batmanacci.cpp", "C++", 32, 0, 0, 1, 4, 37
"/Users/shiyu./Desktop/CP-Code/Kattis/DSA/Cudoviste.cpp", "C++", 32, 0, 0, 10, 0, 42
"/Users/shiyu./Desktop/CP-Code/Kattis/DSA/Election Paradox.cpp", "C++", 27, 0, 0, 1, 3, 31
"/Users/shiyu./Desktop/CP-Code/Kattis/DSA/ICPC Tutorial.cpp", "C++", 80, 0, 0, 3, 7, 90
"/Users/shiyu./Desktop/CP-Code/Kattis/DSA/Keylogger.cpp", "C++", 33, 0, 0, 8, 2, 43
"/Users/shiyu./Desktop/CP-Code/Kattis/DSA/Nine Knights.cpp", "C++", 39, 0, 0, 1, 3, 43
"/Users/shiyu./Desktop/CP-Code/Kattis/DSA/Printing Costs.cpp", "C++", 47, 0, 0, 7, 3, 57
"/Users/shiyu./Desktop/CP-Code/Kattis/DSA/Treasure Hunt.cpp", "C++", 55, 0, 0, 42, 6, 103
"/Users/shiyu./Desktop/CP-Code/Kattis/DSA/Trik.cpp", "C++", 22, 0, 0, 1, 2, 25
"/Users/shiyu./Desktop/CP-Code/NCKU HSPC/2023/Test/Test_pA.cpp", "C++", 6, 0, 0, 0, 2, 8
"/Users/shiyu./Desktop/CP-Code/NCKU HSPC/2023/Test/Test_pB.cpp", "C++", 6, 0, 0, 0, 2, 8
"/Users/shiyu./Desktop/CP-Code/NCKU HSPC/2023/pA.cpp", "C++", 11, 0, 0, 0, 3, 14
"/Users/shiyu./Desktop/CP-Code/NCKU HSPC/2023/pB.cpp", "C++", 7, 0, 0, 0, 4, 11
"/Users/shiyu./Desktop/CP-Code/NCKU HSPC/2023/pC.cpp", "C++", 7, 0, 0, 0, 4, 11
"/Users/shiyu./Desktop/CP-Code/NCKU HSPC/2023/pD.cpp", "C++", 7, 0, 0, 0, 4, 11
"/Users/shiyu./Desktop/CP-Code/NCKU HSPC/2023/pE.cpp", "C++", 21, 0, 0, 0, 3, 24
"/Users/shiyu./Desktop/CP-Code/NCKU HSPC/2023/pF.cpp", "C++", 7, 0, 0, 0, 4, 11
"/Users/shiyu./Desktop/CP-Code/NCKU HSPC/2023/pG.cpp", "C++", 80, 0, 0, 1, 3, 84
"/Users/shiyu./Desktop/CP-Code/NCKU HSPC/2023/test.cpp", "C++", 9, 0, 0, 0, 2, 11
"/Users/shiyu./Desktop/CP-Code/NCKU HSPC/2024/pB+.cpp", "C++", 87, 0, 0, 14, 3, 104
"/Users/shiyu./Desktop/CP-Code/NCKU HSPC/2024/pB.cpp", "C++", 80, 0, 0, 13, 3, 96
"/Users/shiyu./Desktop/CP-Code/NCKU HSPC/2024/pD+.cpp", "C++", 67, 0, 0, 42, 3, 112
"/Users/shiyu./Desktop/CP-Code/NCKU HSPC/2024/pD.cpp", "C++", 85, 0, 0, 13, 3, 101
"/Users/shiyu./Desktop/CP-Code/NCKU HSPC/2024/pG.cpp", "C++", 36, 0, 0, 1, 9, 46
"/Users/shiyu./Desktop/CP-Code/NCKU HSPC/2024/pH.cpp", "C++", 64, 0, 0, 13, 3, 80
"/Users/shiyu./Desktop/CP-Code/NHDK/#16/E.cpp", "C++", 23, 0, 0, 0, 1, 24
"/Users/shiyu./Desktop/CP-Code/NHDK/#40/pA.cpp", "C++", 0, 0, 0, 0, 1, 1
"/Users/shiyu./Desktop/CP-Code/NHSPC/2023 南區複賽/am2.cpp", "C++", 26, 0, 0, 0, 1, 27
"/Users/shiyu./Desktop/CP-Code/NHSPC/2023 南區複賽/am9.cpp", "C++", 36, 0, 0, 0, 1, 37
"/Users/shiyu./Desktop/CP-Code/NHSPC/2023 南區複賽/pm2-1.cpp", "C++", 72, 0, 0, 0, 1, 73
"/Users/shiyu./Desktop/CP-Code/NHSPC/2023 南區複賽/pm2.cpp", "C++", 54, 0, 0, 0, 1, 55
"/Users/shiyu./Desktop/CP-Code/NHSPC/2023 南區複賽/pm6.cpp", "C++", 17, 0, 0, 0, 1, 18
"/Users/shiyu./Desktop/CP-Code/NHSPC/全國模擬賽/pA.cpp", "C++", 40, 0, 0, 1, 2, 43
"/Users/shiyu./Desktop/CP-Code/NHSPC/全國模擬賽/pC.cpp", "C++", 62, 0, 0, 0, 4, 66
"/Users/shiyu./Desktop/CP-Code/NHSPC/全國模擬賽/pE.cpp", "C++", 21, 0, 0, 0, 2, 23
"/Users/shiyu./Desktop/CP-Code/NHSPC/全國模擬賽/pG.cpp", "C++", 51, 0, 0, 0, 3, 54
"/Users/shiyu./Desktop/CP-Code/NTOJ/100.cpp", "C++", 9, 0, 0, 0, 1, 10
"/Users/shiyu./Desktop/CP-Code/NTOJ/101.cpp", "C++", 8, 0, 0, 0, 1, 9
"/Users/shiyu./Desktop/CP-Code/NTOJ/103.cpp", "C++", 13, 0, 0, 0, 1, 14
"/Users/shiyu./Desktop/CP-Code/NTOJ/104-1.cpp", "C++", 12, 0, 0, 0, 1, 13
"/Users/shiyu./Desktop/CP-Code/NTOJ/104.cpp", "C++", 19, 0, 0, 0, 1, 20
"/Users/shiyu./Desktop/CP-Code/NTOJ/11.cpp", "C++", 52, 0, 0, 2, 6, 60
"/Users/shiyu./Desktop/CP-Code/NTOJ/110.cpp", "C++", 30, 0, 0, 9, 5, 44
"/Users/shiyu./Desktop/CP-Code/NTOJ/113.cpp", "C++", 24, 0, 0, 0, 1, 25
"/Users/shiyu./Desktop/CP-Code/NTOJ/114.cpp", "C++", 54, 0, 0, 0, 4, 58
"/Users/shiyu./Desktop/CP-Code/NTOJ/115.cpp", "C++", 15, 0, 0, 0, 1, 16
"/Users/shiyu./Desktop/CP-Code/NTOJ/120.cpp", "C++", 33, 0, 0, 1, 3, 37
"/Users/shiyu./Desktop/CP-Code/NTOJ/127.cpp", "C++", 17, 0, 0, 1, 0, 18
"/Users/shiyu./Desktop/CP-Code/NTOJ/15.cpp", "C++", 59, 0, 0, 1, 5, 65
"/Users/shiyu./Desktop/CP-Code/NTOJ/170.cpp", "C++", 26, 0, 0, 0, 2, 28
"/Users/shiyu./Desktop/CP-Code/NTOJ/18.cpp", "C++", 29, 0, 0, 3, 0, 32
"/Users/shiyu./Desktop/CP-Code/NTOJ/244.cpp", "C++", 14, 0, 0, 0, 1, 15
"/Users/shiyu./Desktop/CP-Code/NTOJ/494.cpp", "C++", 28, 0, 0, 0, 2, 30
"/Users/shiyu./Desktop/CP-Code/NTOJ/5.cpp", "C++", 8, 0, 0, 1, 1, 10
"/Users/shiyu./Desktop/CP-Code/NTOJ/515.cpp", "C++", 23, 0, 0, 1, 1, 25
"/Users/shiyu./Desktop/CP-Code/NTOJ/519.cpp", "C++", 8, 0, 0, 0, 1, 9
"/Users/shiyu./Desktop/CP-Code/NTOJ/520.cpp", "C++", 8, 0, 0, 0, 1, 9
"/Users/shiyu./Desktop/CP-Code/NTOJ/521.cpp", "C++", 8, 0, 0, 0, 1, 9
"/Users/shiyu./Desktop/CP-Code/NTOJ/522.cpp", "C++", 8, 0, 0, 0, 1, 9
"/Users/shiyu./Desktop/CP-Code/NTOJ/523.cpp", "C++", 8, 0, 0, 0, 1, 9
"/Users/shiyu./Desktop/CP-Code/NTOJ/524.cpp", "C++", 8, 0, 0, 0, 1, 9
"/Users/shiyu./Desktop/CP-Code/NTOJ/525.cpp", "C++", 8, 0, 0, 0, 1, 9
"/Users/shiyu./Desktop/CP-Code/NTOJ/526.cpp", "C++", 11, 0, 0, 13, 2, 26
"/Users/shiyu./Desktop/CP-Code/NTOJ/527.cpp", "C++", 15, 0, 0, 0, 1, 16
"/Users/shiyu./Desktop/CP-Code/NTOJ/528.cpp", "C++", 9, 0, 0, 0, 1, 10
"/Users/shiyu./Desktop/CP-Code/NTOJ/529.cpp", "C++", 9, 0, 0, 0, 1, 10
"/Users/shiyu./Desktop/CP-Code/NTOJ/530.cpp", "C++", 9, 0, 0, 0, 2, 11
"/Users/shiyu./Desktop/CP-Code/NTOJ/531.cpp", "C++", 9, 0, 0, 0, 1, 10
"/Users/shiyu./Desktop/CP-Code/NTOJ/532.cpp", "C++", 12, 0, 0, 0, 1, 13
"/Users/shiyu./Desktop/CP-Code/NTOJ/533.cpp", "C++", 9, 0, 0, 0, 1, 10
"/Users/shiyu./Desktop/CP-Code/NTOJ/534.cpp", "C++", 9, 0, 0, 0, 1, 10
"/Users/shiyu./Desktop/CP-Code/NTOJ/535.cpp", "C++", 13, 0, 0, 0, 1, 14
"/Users/shiyu./Desktop/CP-Code/NTOJ/536.cpp", "C++", 9, 0, 0, 0, 1, 10
"/Users/shiyu./Desktop/CP-Code/NTOJ/537.cpp", "C++", 22, 0, 0, 0, 1, 23
"/Users/shiyu./Desktop/CP-Code/NTOJ/55.cpp", "C++", 27, 0, 0, 0, 3, 30
"/Users/shiyu./Desktop/CP-Code/NTOJ/576.cpp", "C++", 13, 0, 0, 0, 1, 14
"/Users/shiyu./Desktop/CP-Code/NTOJ/577.cpp", "C++", 22, 0, 0, 0, 1, 23
"/Users/shiyu./Desktop/CP-Code/NTOJ/578.cpp", "C++", 12, 0, 0, 0, 1, 13
"/Users/shiyu./Desktop/CP-Code/NTOJ/658.cpp", "C++", 21, 0, 0, 0, 2, 23
"/Users/shiyu./Desktop/CP-Code/NTOJ/92.cpp", "C++", 8, 0, 0, 0, 1, 9
"/Users/shiyu./Desktop/CP-Code/NTOJ/94.cpp", "C++", 11, 0, 0, 0, 1, 12
"/Users/shiyu./Desktop/CP-Code/NTOJ/98.cpp", "C++", 11, 0, 0, 0, 1, 12
"/Users/shiyu./Desktop/CP-Code/SA/0912/ABC220-C.cpp", "C++", 30, 0, 0, 0, 2, 32
"/Users/shiyu./Desktop/CP-Code/SA/0912/ABC353-C.cpp", "C++", 22, 0, 0, 0, 1, 23
"/Users/shiyu./Desktop/CP-Code/SA/0912/d193.cpp", "C++", 17, 0, 0, 0, 1, 18
"/Users/shiyu./Desktop/CP-Code/SA/0919/ARC082-C.cpp", "C++", 17, 0, 0, 0, 2, 19
"/Users/shiyu./Desktop/CP-Code/SA/0919/Conformity.cpp", "C++", 33, 0, 0, 1, 2, 36
"/Users/shiyu./Desktop/CP-Code/SA/0919/Hot Springs.cpp", "C++", 16, 0, 0, 1, 2, 19
"/Users/shiyu./Desktop/CP-Code/SA/0919/Packagemanager.cpp", "C++", 39, 0, 0, 0, 3, 42
"/Users/shiyu./Desktop/CP-Code/SA/0919/Phone List.cpp", "C++", 24, 0, 0, 0, 1, 25
"/Users/shiyu./Desktop/CP-Code/SA/0919/Pivot.cpp", "C++", 28, 0, 0, 0, 2, 30
"/Users/shiyu./Desktop/CP-Code/SA/0919/Streets Ahead.cpp", "C++", 26, 0, 0, 0, 3, 29
"/Users/shiyu./Desktop/CP-Code/SA/0919/UVa-p836.cpp", "C++", 30, 0, 0, 0, 2, 32
"/Users/shiyu./Desktop/CP-Code/SA/0919/typical90-058.cpp", "C++", 33, 0, 0, 0, 3, 36
"/Users/shiyu./Desktop/CP-Code/SA/0919/ Massive Card Game.cpp", "C++", 15, 0, 0, 0, 1, 16
"/Users/shiyu./Desktop/CP-Code/SA/test.cpp", "C++", 6, 0, 0, 0, 2, 8
"/Users/shiyu./Desktop/CP-Code/SCIST/S3 期中考/SCIST-Mid/Circle/generator/gen1.cpp", "C++", 15, 0, 0, 0, 0, 15
"/Users/shiyu./Desktop/CP-Code/SCIST/S3 期中考/SCIST-Mid/Circle/generator/gen2.cpp", "C++", 17, 0, 0, 0, 1, 18
"/Users/shiyu./Desktop/CP-Code/SCIST/S3 期中考/SCIST-Mid/Circle/generator/gen3.cpp", "C++", 15, 0, 0, 0, 1, 16
"/Users/shiyu./Desktop/CP-Code/SCIST/S3 期中考/SCIST-Mid/Circle/solution/koying.cpp", "C++", 29, 0, 0, 0, 9, 38
"/Users/shiyu./Desktop/CP-Code/SCIST/S3 期中考/SCIST-Mid/Circle/solution/official.cpp", "C++", 30, 0, 0, 0, 0, 30
"/Users/shiyu./Desktop/CP-Code/SCIST/S3 期中考/SCIST-Mid/Circle/statement/C. Circle.tex", "LaTeX", 0, 134, 0, 4, 40, 178
"/Users/shiyu./Desktop/CP-Code/SCIST/S3 期中考/SCIST-Mid/Circle/validator/validator.cpp", "C++", 21, 0, 0, 0, 6, 27
"/Users/shiyu./Desktop/CP-Code/SCIST/S3 期中考/SCIST-Mid/DNA/generator/gen1.cpp", "C++", 31, 0, 0, 0, 3, 34
"/Users/shiyu./Desktop/CP-Code/SCIST/S3 期中考/SCIST-Mid/DNA/generator/gen2.cpp", "C++", 37, 0, 0, 0, 4, 41
"/Users/shiyu./Desktop/CP-Code/SCIST/S3 期中考/SCIST-Mid/DNA/generator/gen3.cpp", "C++", 31, 0, 0, 0, 3, 34
"/Users/shiyu./Desktop/CP-Code/SCIST/S3 期中考/SCIST-Mid/DNA/solution/koying.cpp", "C++", 20, 0, 0, 0, 8, 28
"/Users/shiyu./Desktop/CP-Code/SCIST/S3 期中考/SCIST-Mid/DNA/solution/official.cpp", "C++", 25, 0, 0, 0, 0, 25
"/Users/shiyu./Desktop/CP-Code/SCIST/S3 期中考/SCIST-Mid/DNA/statement/A. DNA.tex", "LaTeX", 0, 135, 0, 3, 42, 180
"/Users/shiyu./Desktop/CP-Code/SCIST/S3 期中考/SCIST-Mid/DNA/validator/validator.cpp", "C++", 32, 0, 0, 0, 10, 42
"/Users/shiyu./Desktop/CP-Code/SCIST/S3 期中考/SCIST-Mid/Queue/generator/gen1.cpp", "C++", 43, 0, 0, 0, 13, 56
"/Users/shiyu./Desktop/CP-Code/SCIST/S3 期中考/SCIST-Mid/Queue/generator/gen2.cpp", "C++", 43, 0, 0, 0, 13, 56
"/Users/shiyu./Desktop/CP-Code/SCIST/S3 期中考/SCIST-Mid/Queue/generator/gen3.cpp", "C++", 43, 0, 0, 0, 13, 56
"/Users/shiyu./Desktop/CP-Code/SCIST/S3 期中考/SCIST-Mid/Queue/solution/official.cpp", "C++", 78, 0, 0, 0, 10, 88
"/Users/shiyu./Desktop/CP-Code/SCIST/S3 期中考/SCIST-Mid/Queue/statement/D. Queue.tex", "LaTeX", 0, 136, 0, 3, 37, 176
"/Users/shiyu./Desktop/CP-Code/SCIST/S3 期中考/SCIST-Mid/Queue/validator/validator.cpp", "C++", 40, 0, 0, 3, 14, 57
"/Users/shiyu./Desktop/CP-Code/SCIST/S3 期中考/SCIST-Mid/Reverse/generator/gen1.cpp", "C++", 43, 0, 0, 0, 2, 45
"/Users/shiyu./Desktop/CP-Code/SCIST/S3 期中考/SCIST-Mid/Reverse/generator/gen2.cpp", "C++", 42, 0, 0, 0, 4, 46
"/Users/shiyu./Desktop/CP-Code/SCIST/S3 期中考/SCIST-Mid/Reverse/solution/koying.cpp", "C++", 32, 0, 0, 0, 6, 38
"/Users/shiyu./Desktop/CP-Code/SCIST/S3 期中考/SCIST-Mid/Reverse/solution/official.cpp", "C++", 49, 0, 0, 0, 1, 50
"/Users/shiyu./Desktop/CP-Code/SCIST/S3 期中考/SCIST-Mid/Reverse/statement/E. Reverse.tex", "LaTeX", 0, 129, 0, 2, 40, 171
"/Users/shiyu./Desktop/CP-Code/SCIST/S3 期中考/SCIST-Mid/Reverse/validator/validator.cpp", "C++", 33, 0, 0, 0, 10, 43
"/Users/shiyu./Desktop/CP-Code/SCIST/S3 期中考/SCIST-Mid/Scoreboard/generator/gen1.cpp", "C++", 49, 0, 0, 0, 13, 62
"/Users/shiyu./Desktop/CP-Code/SCIST/S3 期中考/SCIST-Mid/Scoreboard/generator/gen2.cpp", "C++", 49, 0, 0, 0, 13, 62
"/Users/shiyu./Desktop/CP-Code/SCIST/S3 期中考/SCIST-Mid/Scoreboard/solution/official.cpp", "C++", 47, 0, 0, 0, 9, 56
"/Users/shiyu./Desktop/CP-Code/SCIST/S3 期中考/SCIST-Mid/Scoreboard/statement/B. Scoreboard.tex", "LaTeX", 0, 140, 0, 2, 46, 188
"/Users/shiyu./Desktop/CP-Code/SCIST/S3 期中考/SCIST-Mid/Scoreboard/validator/validator.cpp", "C++", 43, 0, 0, 1, 13, 57
"/Users/shiyu./Desktop/CP-Code/SCIST/S3 期中考/期中考 Mirror code/pA.cpp", "C++", 27, 0, 0, 0, 2, 29
"/Users/shiyu./Desktop/CP-Code/SCIST/S4 季中賽/pA.cpp", "C++", 66, 0, 0, 2, 6, 74
"/Users/shiyu./Desktop/CP-Code/SCIST/S4 季中賽/pB.cpp", "C++", 97, 0, 0, 2, 5, 104
"/Users/shiyu./Desktop/CP-Code/SCIST/S4 季中賽/pC.cpp", "C++", 62, 0, 0, 2, 4, 68
"/Users/shiyu./Desktop/CP-Code/SCIST/S4 季中賽/pD.cpp", "C++", 71, 0, 0, 2, 6, 79
"/Users/shiyu./Desktop/CP-Code/SCIST/S4 季中賽/pE.cpp", "C++", 61, 0, 0, 2, 6, 69
"/Users/shiyu./Desktop/CP-Code/SCIST/演算試辦 20230909/pA.cpp", "C++", 13, 0, 0, 0, 3, 16
"/Users/shiyu./Desktop/CP-Code/SCIST/演算試辦 20230909/pB.cpp", "C++", 14, 0, 0, 0, 3, 17
"/Users/shiyu./Desktop/CP-Code/SCIST/演算試辦 20230909/pC.cpp", "C++", 21, 0, 0, 0, 3, 24
"/Users/shiyu./Desktop/CP-Code/SCIST/演算試辦 20230909/pD.cpp", "C++", 14, 0, 0, 0, 3, 17
"/Users/shiyu./Desktop/CP-Code/SCIST/演算試辦 20230909/pE.cpp", "C++", 16, 0, 0, 0, 3, 19
"/Users/shiyu./Desktop/CP-Code/SCIST/演算試辦 20230909/pF.cpp", "C++", 22, 0, 0, 0, 3, 25
"/Users/shiyu./Desktop/CP-Code/SCIST/演算試辦 20230909/pG.cpp", "C++", 17, 0, 0, 0, 3, 20
"/Users/shiyu./Desktop/CP-Code/SCIST/演算試辦 20230909/pH.cpp", "C++", 20, 0, 0, 0, 3, 23
"/Users/shiyu./Desktop/CP-Code/SCIST/演算試辦 20230909/pI.cpp", "C++", 22, 0, 0, 0, 1, 23
"/Users/shiyu./Desktop/CP-Code/SCIST/演算試辦 20230909/pJ.cpp", "C++", 15, 0, 0, 0, 2, 17
"/Users/shiyu./Desktop/CP-Code/SCIST/演算試辦 20230909/pK.cpp", "C++", 32, 0, 0, 0, 2, 34
"/Users/shiyu./Desktop/CP-Code/SCIST/演算試辦 20230909/pL.cpp", "C++", 21, 0, 0, 0, 2, 23
"/Users/shiyu./Desktop/CP-Code/SCIST/演算試辦 20230909/pM.cpp", "C++", 23, 0, 0, 0, 2, 25
"/Users/shiyu./Desktop/CP-Code/SCIST/演算試辦 20230909/pN.cpp", "C++", 34, 0, 0, 0, 1, 35
"/Users/shiyu./Desktop/CP-Code/TIOJ/(undone)1249.cpp", "C++", 38, 0, 0, 1, 2, 41
"/Users/shiyu./Desktop/CP-Code/TIOJ/1809.cpp", "C++", 27, 0, 0, 0, 1, 28
"/Users/shiyu./Desktop/CP-Code/TIOJ/1911.cpp", "C++", 35, 0, 0, 0, 1, 36
"/Users/shiyu./Desktop/CP-Code/TNHSPA/2023-02-A.cpp", "C++", 29, 0, 0, 9, 0, 38
"/Users/shiyu./Desktop/CP-Code/TOI/AA 模擬賽/pA.cpp", "C++", 112, 0, 0, 10, 8, 130
"/Users/shiyu./Desktop/CP-Code/TOI/新手同好會/2019-08/p1-e834.cpp", "C++", 12, 0, 0, 0, 1, 13
"/Users/shiyu./Desktop/CP-Code/TOI/新手同好會/2019-08/p2-e835.cpp", "C++", 43, 0, 0, 0, 1, 44
"/Users/shiyu./Desktop/CP-Code/TOI/練習賽/新手組/2019-03/p3-e969.cpp", "C++", 24, 0, 0, 0, 2, 26
"/Users/shiyu./Desktop/CP-Code/TOI/練習賽/新手組/2023-10/pA.cpp", "C++", 8, 0, 0, 0, 1, 9
"/Users/shiyu./Desktop/CP-Code/TOI/練習賽/新手組/2023-10/pB.cpp", "C++", 20, 0, 0, 0, 1, 21
"/Users/shiyu./Desktop/CP-Code/TOI/練習賽/新手組/2023-10/pC.cpp", "C++", 27, 0, 0, 0, 1, 28
"/Users/shiyu./Desktop/CP-Code/TOI/練習賽/潛力組/2023-12/pA-cost.cpp", "C++", 71, 0, 0, 2, 6, 79
"/Users/shiyu./Desktop/CP-Code/TOI/練習賽/潛力組/2023-12/pB-chess.cpp", "C++", 81, 0, 0, 2, 6, 89
"/Users/shiyu./Desktop/CP-Code/TOI/練習賽/潛力組/2023-12/pC-TreasureBowl.cpp", "C++", 66, 0, 0, 3, 3, 72
"/Users/shiyu./Desktop/CP-Code/Template-CP.cpp", "C++", 56, 0, 0, 11, 3, 70
"/Users/shiyu./Desktop/CP-Code/Template-P.cpp", "C++", 24, 0, 0, 0, 1, 25
"/Users/shiyu./Desktop/CP-Code/Uncategorized/pC.cpp", "C++", 35, 0, 0, 0, 7, 42
"/Users/shiyu./Desktop/CP-Code/YTP/2022_Pre/pA.cpp", "C++", 41, 0, 0, 0, 1, 42
"/Users/shiyu./Desktop/CP-Code/YTP/2024_Pre/p0.cpp", "C++", 25, 0, 0, 0, 1, 26
"/Users/shiyu./Desktop/CP-Code/YTP/2024_Pre/p2.cpp", "C++", 77, 0, 0, 14, 3, 94
"/Users/shiyu./Desktop/CP-Code/YTP/2024_Pre/p8.cpp", "C++", 49, 0, 0, 2, 5, 56
"/Users/shiyu./Desktop/CP-Code/ZeroJudge/(undone)k731.cpp", "C++", 12, 0, 0, 0, 2, 14
"/Users/shiyu./Desktop/CP-Code/ZeroJudge/Basic Syntax/U10/(undone)d044.cpp", "C++", 0, 0, 0, 0, 1, 1
"/Users/shiyu./Desktop/CP-Code/ZeroJudge/Basic Syntax/U10/(undone)f168.cpp", "C++", 40, 0, 0, 1, 3, 44
"/Users/shiyu./Desktop/CP-Code/ZeroJudge/Basic Syntax/U10/c002.cpp", "C++", 25, 0, 0, 0, 3, 28
"/Users/shiyu./Desktop/CP-Code/ZeroJudge/Basic Syntax/U10/c813.cpp", "C++", 28, 0, 0, 0, 3, 31
"/Users/shiyu./Desktop/CP-Code/ZeroJudge/Basic Syntax/U11/(undone)c875.cpp", "C++", 0, 0, 0, 0, 1, 1
"/Users/shiyu./Desktop/CP-Code/ZeroJudge/Basic Syntax/U11/(undone)e564.cpp", "C++", 71, 0, 0, 0, 2, 73
"/Users/shiyu./Desktop/CP-Code/ZeroJudge/Basic Syntax/U11/a135.cpp", "C++", 32, 0, 0, 0, 1, 33
"/Users/shiyu./Desktop/CP-Code/ZeroJudge/Basic Syntax/U11/b231.cpp", "C++", 43, 0, 0, 0, 3, 46
"/Users/shiyu./Desktop/CP-Code/ZeroJudge/Basic Syntax/U11/b838.cpp", "C++", 41, 0, 0, 0, 3, 44
"/Users/shiyu./Desktop/CP-Code/ZeroJudge/Basic Syntax/U11/c123.cpp", "C++", 34, 0, 0, 0, 2, 36
"/Users/shiyu./Desktop/CP-Code/ZeroJudge/Basic Syntax/U11/d123.cpp", "C++", 33, 0, 0, 0, 1, 34
"/Users/shiyu./Desktop/CP-Code/ZeroJudge/Basic Syntax/U11/d221.cpp", "C++", 37, 0, 0, 0, 2, 39
"/Users/shiyu./Desktop/CP-Code/ZeroJudge/Basic Syntax/U11/d442.cpp", "C++", 39, 0, 0, 0, 3, 42
"/Users/shiyu./Desktop/CP-Code/ZeroJudge/Basic Syntax/U11/d980.cpp", "C++", 30, 0, 0, 0, 2, 32
"/Users/shiyu./Desktop/CP-Code/ZeroJudge/Basic Syntax/U11/e155.cpp", "C++", 34, 0, 0, 0, 2, 36
"/Users/shiyu./Desktop/CP-Code/ZeroJudge/Basic Syntax/U11/e446.cpp", "C++", 32, 0, 0, 6, 5, 43
"/Users/shiyu./Desktop/CP-Code/ZeroJudge/Basic Syntax/U11/e529.cpp", "C++", 34, 0, 0, 0, 2, 36
"/Users/shiyu./Desktop/CP-Code/ZeroJudge/Basic Syntax/U11/e641.cpp", "C++", 36, 0, 0, 0, 2, 38
"/Users/shiyu./Desktop/CP-Code/ZeroJudge/Basic Syntax/U11/f607.cpp", "C++", 35, 0, 0, 0, 2, 37
"/Users/shiyu./Desktop/CP-Code/ZeroJudge/Basic Syntax/U11/f640.cpp", "C++", 46, 0, 0, 0, 4, 50
"/Users/shiyu./Desktop/CP-Code/ZeroJudge/Basic Syntax/U2/U2 test &取址 sixeof().cpp", "C++", 10, 0, 0, 0, 1, 11
"/Users/shiyu./Desktop/CP-Code/ZeroJudge/Basic Syntax/U2/U2 test 找錢問題 用最少硬幣.cpp", "C++", 15, 0, 0, 0, 1, 16
"/Users/shiyu./Desktop/CP-Code/ZeroJudge/Basic Syntax/U2/U2 test 長方形面積&邊長.cpp", "C++", 12, 0, 0, 0, 1, 13
"/Users/shiyu./Desktop/CP-Code/ZeroJudge/Basic Syntax/U2/a001.cpp", "C++", 9, 0, 0, 0, 2, 11
"/Users/shiyu./Desktop/CP-Code/ZeroJudge/Basic Syntax/U2/a002.cpp", "C++", 9, 0, 0, 0, 2, 11
"/Users/shiyu./Desktop/CP-Code/ZeroJudge/Basic Syntax/U2/d049.cpp", "C++", 9, 0, 0, 0, 2, 11
"/Users/shiyu./Desktop/CP-Code/ZeroJudge/Basic Syntax/U2/d050.cpp", "C++", 13, 0, 0, 0, 2, 15
"/Users/shiyu./Desktop/CP-Code/ZeroJudge/Basic Syntax/U2/d051.cpp", "C++", 10, 0, 0, 2, 2, 14
"/Users/shiyu./Desktop/CP-Code/ZeroJudge/Basic Syntax/U2/d073.cpp", "C++", 13, 0, 0, 0, 1, 14
"/Users/shiyu./Desktop/CP-Code/ZeroJudge/Basic Syntax/U2/d827.cpp", "C++", 9, 0, 0, 0, 1, 10
"/Users/shiyu./Desktop/CP-Code/ZeroJudge/Basic Syntax/U3/a003.cpp", "C++", 16, 0, 0, 1, 2, 19
"/Users/shiyu./Desktop/CP-Code/ZeroJudge/Basic Syntax/U3/d058.cpp", "C++", 10, 0, 0, 0, 1, 11
"/Users/shiyu./Desktop/CP-Code/ZeroJudge/Basic Syntax/U3/d060.cpp", "C++", 9, 0, 0, 0, 1, 10
"/Users/shiyu./Desktop/CP-Code/ZeroJudge/Basic Syntax/U3/d063.cpp", "C++", 8, 0, 0, 0, 1, 9
"/Users/shiyu./Desktop/CP-Code/ZeroJudge/Basic Syntax/U3/d064.cpp", "C++", 9, 0, 0, 0, 1, 10
"/Users/shiyu./Desktop/CP-Code/ZeroJudge/Basic Syntax/U3/d065.cpp", "C++", 10, 0, 0, 0, 1, 11
"/Users/shiyu./Desktop/CP-Code/ZeroJudge/Basic Syntax/U3/d066.cpp", "C++", 9, 0, 0, 0, 1, 10
"/Users/shiyu./Desktop/CP-Code/ZeroJudge/Basic Syntax/U3/d067.cpp", "C++", 9, 0, 0, 7, 1, 17
"/Users/shiyu./Desktop/CP-Code/ZeroJudge/Basic Syntax/U3/d068.cpp", "C++", 9, 0, 0, 0, 1, 10
"/Users/shiyu./Desktop/CP-Code/ZeroJudge/Basic Syntax/U3/d669.cpp", "C++", 15, 0, 0, 0, 1, 16
"/Users/shiyu./Desktop/CP-Code/ZeroJudge/Basic Syntax/U3/e835.cpp", "C++", 43, 0, 0, 0, 1, 44
"/Users/shiyu./Desktop/CP-Code/ZeroJudge/Basic Syntax/U3/test 簡易計算機.cpp", "C++", 31, 0, 0, 0, 1, 32
"/Users/shiyu./Desktop/CP-Code/ZeroJudge/Basic Syntax/U4/a005.cpp", "C++", 18, 0, 0, 0, 1, 19
"/Users/shiyu./Desktop/CP-Code/ZeroJudge/Basic Syntax/U4/a058.cpp", "C++", 25, 0, 0, 33, 5, 63
"/Users/shiyu./Desktop/CP-Code/ZeroJudge/Basic Syntax/U4/c005.cpp", "C++", 19, 0, 0, 0, 1, 20
"/Users/shiyu./Desktop/CP-Code/ZeroJudge/Basic Syntax/U4/c022.cpp", "C++", 17, 0, 0, 0, 1, 18
"/Users/shiyu./Desktop/CP-Code/ZeroJudge/Basic Syntax/U4/d069.cpp", "C++", 13, 0, 0, 0, 1, 14
"/Users/shiyu./Desktop/CP-Code/ZeroJudge/Basic Syntax/U4/d072.cpp", "C++", 14, 0, 0, 0, 2, 16
"/Users/shiyu./Desktop/CP-Code/ZeroJudge/Basic Syntax/U4/d074.cpp", "C++", 13, 0, 0, 0, 1, 14
"/Users/shiyu./Desktop/CP-Code/ZeroJudge/Basic Syntax/U4/e511.cpp", "C++", 19, 0, 0, 0, 1, 20
"/Users/shiyu./Desktop/CP-Code/ZeroJudge/Basic Syntax/U4/e968.cpp", "C++", 16, 0, 0, 0, 1, 17
"/Users/shiyu./Desktop/CP-Code/ZeroJudge/Basic Syntax/U5/a010.cpp", "C++", 24, 0, 0, 5, 1, 30
"/Users/shiyu./Desktop/CP-Code/ZeroJudge/Basic Syntax/U5/a025.cpp", "C++", 14, 0, 0, 0, 1, 15
"/Users/shiyu./Desktop/CP-Code/ZeroJudge/Basic Syntax/U5/a147.cpp", "C++", 15, 0, 0, 0, 1, 16
"/Users/shiyu./Desktop/CP-Code/ZeroJudge/Basic Syntax/U5/a148.cpp", "C++", 17, 0, 0, 0, 1, 18
"/Users/shiyu./Desktop/CP-Code/ZeroJudge/Basic Syntax/U5/c067.cpp", "C++", 22, 0, 0, 0, 1, 23
"/Users/shiyu./Desktop/CP-Code/ZeroJudge/Basic Syntax/U5/c079.cpp", "C++", 18, 0, 0, 0, 1, 19
"/Users/shiyu./Desktop/CP-Code/ZeroJudge/Basic Syntax/U5/d010.cpp", "C++", 29, 0, 0, 0, 2, 31
"/Users/shiyu./Desktop/CP-Code/ZeroJudge/Basic Syntax/U5/d053.cpp", "C++", 7, 0, 0, 0, 1, 8
"/Users/shiyu./Desktop/CP-Code/ZeroJudge/Basic Syntax/U5/d070.cpp", "C++", 11, 0, 0, 0, 1, 12
"/Users/shiyu./Desktop/CP-Code/ZeroJudge/Basic Syntax/U5/d071.cpp", "C++", 11, 0, 0, 0, 1, 12
"/Users/shiyu./Desktop/CP-Code/ZeroJudge/Basic Syntax/U5/d189.cpp", "C++", 17, 0, 0, 0, 1, 18
"/Users/shiyu./Desktop/CP-Code/ZeroJudge/Basic Syntax/U5/e834.cpp", "C++", 12, 0, 0, 0, 1, 13
"/Users/shiyu./Desktop/CP-Code/ZeroJudge/Basic Syntax/U5/e969.cpp", "C++", 24, 0, 0, 0, 2, 26
"/Users/shiyu./Desktop/CP-Code/ZeroJudge/Basic Syntax/U6/a015.cpp", "C++", 26, 0, 0, 0, 1, 27
"/Users/shiyu./Desktop/CP-Code/ZeroJudge/Basic Syntax/U6/a040.cpp", "C++", 35, 0, 0, 1, 3, 39
"/Users/shiyu./Desktop/CP-Code/ZeroJudge/Basic Syntax/U6/a693.cpp", "C++", 22, 0, 0, 32, 7, 61
"/Users/shiyu./Desktop/CP-Code/ZeroJudge/Basic Syntax/U6/b130.cpp", "C++", 14, 0, 0, 0, 1, 15
"/Users/shiyu./Desktop/CP-Code/ZeroJudge/Basic Syntax/U6/b367.cpp", "C++", 34, 0, 0, 1, 2, 37
"/Users/shiyu./Desktop/CP-Code/ZeroJudge/Basic Syntax/U6/c013.cpp", "C++", 33, 0, 0, 0, 1, 34
"/Users/shiyu./Desktop/CP-Code/ZeroJudge/Basic Syntax/U6/c085.cpp", "C++", 20, 0, 0, 0, 1, 21
"/Users/shiyu./Desktop/CP-Code/ZeroJudge/Basic Syntax/U6/c135.cpp", "C++", 51, 0, 0, 1, 5, 57
"/Users/shiyu./Desktop/CP-Code/ZeroJudge/Basic Syntax/U6/d097.cpp", "C++", 0, 0, 0, 0, 1, 1
"/Users/shiyu./Desktop/CP-Code/ZeroJudge/Basic Syntax/U6/d673.cpp", "C++", 27, 0, 0, 0, 1, 28
"/Users/shiyu./Desktop/CP-Code/ZeroJudge/Basic Syntax/U7/(undone)a006.cpp", "C++", 0, 0, 0, 0, 1, 1
"/Users/shiyu./Desktop/CP-Code/ZeroJudge/Basic Syntax/U7/d039.cpp", "C++", 12, 0, 0, 0, 1, 13
"/Users/shiyu./Desktop/CP-Code/ZeroJudge/Basic Syntax/U7/d225.cpp", "C++", 25, 0, 0, 1, 3, 29
"/Users/shiyu./Desktop/CP-Code/ZeroJudge/Basic Syntax/U8/a065.cpp", "C++", 23, 0, 0, 0, 2, 25
"/Users/shiyu./Desktop/CP-Code/ZeroJudge/Basic Syntax/U8/a130.cpp", "C++", 28, 0, 0, 0, 1, 29
"/Users/shiyu./Desktop/CP-Code/ZeroJudge/Basic Syntax/U8/b428.cpp", "C++", 15, 0, 0, 0, 1, 16
"/Users/shiyu./Desktop/CP-Code/ZeroJudge/Basic Syntax/U8/c015.cpp", "C++", 39, 0, 0, 1, 4, 44
"/Users/shiyu./Desktop/CP-Code/ZeroJudge/Basic Syntax/U8/c459.cpp", "C++", 40, 0, 0, 3, 5, 48
"/Users/shiyu./Desktop/CP-Code/ZeroJudge/Basic Syntax/U8/d235.cpp", "C++", 28, 0, 0, 2, 3, 33
"/Users/shiyu./Desktop/CP-Code/ZeroJudge/Basic Syntax/U8/d267.cpp", "C++", 37, 0, 0, 0, 2, 39
"/Users/shiyu./Desktop/CP-Code/ZeroJudge/Basic Syntax/U8/d275.cpp", "C++", 40, 0, 0, 2, 3, 45
"/Users/shiyu./Desktop/CP-Code/ZeroJudge/Basic Syntax/U8/d671.cpp", "C++", 44, 0, 0, 1, 4, 49
"/Users/shiyu./Desktop/CP-Code/ZeroJudge/Basic Syntax/U9/d091.cpp", "C++", 48, 0, 0, 0, 3, 51
"/Users/shiyu./Desktop/CP-Code/ZeroJudge/a059.cpp", "C++", 36, 0, 0, 0, 1, 37
"/Users/shiyu./Desktop/CP-Code/ZeroJudge/a159.cpp", "C++", 36, 0, 0, 0, 4, 40
"/Users/shiyu./Desktop/CP-Code/ZeroJudge/a414.cpp", "C++", 19, 0, 0, 0, 2, 21
"/Users/shiyu./Desktop/CP-Code/ZeroJudge/a445.cpp", "C++", 45, 0, 0, 1, 5, 51
"/Users/shiyu./Desktop/CP-Code/ZeroJudge/a694.cpp", "C++", 25, 0, 0, 25, 11, 61
"/Users/shiyu./Desktop/CP-Code/ZeroJudge/a915.cpp", "C++", 17, 0, 0, 0, 1, 18
"/Users/shiyu./Desktop/CP-Code/ZeroJudge/b304.cpp", "C++", 29, 0, 0, 45, 6, 80
"/Users/shiyu./Desktop/CP-Code/ZeroJudge/b343.cpp", "C++", 45, 0, 0, 1, 5, 51
"/Users/shiyu./Desktop/CP-Code/ZeroJudge/b548.cpp", "C++", 61, 0, 0, 5, 5, 71
"/Users/shiyu./Desktop/CP-Code/ZeroJudge/b844.cpp", "C++", 36, 0, 0, 0, 2, 38
"/Users/shiyu./Desktop/CP-Code/ZeroJudge/c007.cpp", "C++", 34, 0, 0, 0, 3, 37
"/Users/shiyu./Desktop/CP-Code/ZeroJudge/c054.cpp", "C++", 27, 0, 0, 1, 3, 31
"/Users/shiyu./Desktop/CP-Code/ZeroJudge/c067.cpp", "C++", 27, 0, 0, 0, 2, 29
"/Users/shiyu./Desktop/CP-Code/ZeroJudge/c294.py", "Python", 0, 0, 16, 0, 3, 19
"/Users/shiyu./Desktop/CP-Code/ZeroJudge/c382.cpp", "C++", 24, 0, 0, 0, 3, 27
"/Users/shiyu./Desktop/CP-Code/ZeroJudge/c547.cpp", "C++", 17, 0, 0, 0, 3, 20
"/Users/shiyu./Desktop/CP-Code/ZeroJudge/d046.cpp", "C++", 14, 0, 0, 15, 4, 33
"/Users/shiyu./Desktop/CP-Code/ZeroJudge/d098.cpp", "C++", 33, 0, 0, 0, 2, 35
"/Users/shiyu./Desktop/CP-Code/ZeroJudge/d133.cpp", "C++", 22, 0, 0, 0, 3, 25
"/Users/shiyu./Desktop/CP-Code/ZeroJudge/d143.cpp", "C++", 15, 0, 0, 0, 1, 16
"/Users/shiyu./Desktop/CP-Code/ZeroJudge/d186.cpp", "C++", 14, 0, 0, 0, 0, 14
"/Users/shiyu./Desktop/CP-Code/ZeroJudge/d226.cpp", "C++", 10, 0, 0, 0, 1, 11
"/Users/shiyu./Desktop/CP-Code/ZeroJudge/d267.cpp", "C++", 27, 0, 0, 0, 1, 28
"/Users/shiyu./Desktop/CP-Code/ZeroJudge/d305.cpp", "C++", 17, 0, 0, 15, 6, 38
"/Users/shiyu./Desktop/CP-Code/ZeroJudge/d483.cpp", "C++", 6, 0, 0, 0, 1, 7
"/Users/shiyu./Desktop/CP-Code/ZeroJudge/d498.cpp", "C++", 10, 0, 0, 4, 1, 15
"/Users/shiyu./Desktop/CP-Code/ZeroJudge/d518.cpp", "C++", 25, 0, 0, 0, 1, 26
"/Users/shiyu./Desktop/CP-Code/ZeroJudge/d539.cpp", "C++", 46, 0, 0, 1, 6, 53
"/Users/shiyu./Desktop/CP-Code/ZeroJudge/d660.cpp", "C++", 26, 0, 0, 0, 3, 29
"/Users/shiyu./Desktop/CP-Code/ZeroJudge/d831.cpp", "C++", 47, 0, 0, 1, 5, 53
"/Users/shiyu./Desktop/CP-Code/ZeroJudge/e208.cpp", "C++", 34, 0, 0, 1, 3, 38
"/Users/shiyu./Desktop/CP-Code/ZeroJudge/e339.cpp", "C++", 18, 0, 0, 20, 5, 43
"/Users/shiyu./Desktop/CP-Code/ZeroJudge/e447.cpp", "C++", 56, 0, 0, 0, 5, 61
"/Users/shiyu./Desktop/CP-Code/ZeroJudge/e533.cpp", "C++", 29, 0, 0, 0, 2, 31
"/Users/shiyu./Desktop/CP-Code/ZeroJudge/e575.cpp", "C++", 40, 0, 0, 1, 4, 45
"/Users/shiyu./Desktop/CP-Code/ZeroJudge/e605-1(undone).cpp", "C++", 0, 0, 0, 1, 0, 1
"/Users/shiyu./Desktop/CP-Code/ZeroJudge/e605.cpp", "C++", 41, 0, 0, 1, 3, 45
"/Users/shiyu./Desktop/CP-Code/ZeroJudge/e623.cpp", "C++", 20, 0, 0, 0, 2, 22
"/Users/shiyu./Desktop/CP-Code/ZeroJudge/e915.cpp", "C++", 17, 0, 0, 1, 1, 19
"/Users/shiyu./Desktop/CP-Code/ZeroJudge/f345.cpp", "C++", 11, 0, 0, 0, 2, 13
"/Users/shiyu./Desktop/CP-Code/ZeroJudge/f677.cpp", "C++", 41, 0, 0, 1, 4, 46
"/Users/shiyu./Desktop/CP-Code/ZeroJudge/f819.cpp", "C++", 33, 0, 0, 1, 3, 37
"/Users/shiyu./Desktop/CP-Code/ZeroJudge/i213.cpp", "C++", 22, 0, 0, 0, 1, 23
"/Users/shiyu./Desktop/CP-Code/ZeroJudge/j057.cpp", "C++", 22, 0, 0, 1, 2, 25
"/Users/shiyu./Desktop/CP-Code/ZeroJudge/k402.cpp", "C++", 42, 0, 0, 1, 3, 46
"/Users/shiyu./Desktop/CP-Code/ZeroJudge/k621.cpp", "C++", 36, 0, 0, 0, 2, 38
"/Users/shiyu./Desktop/CP-Code/ZeroJudge/m273.cpp", "C++", 41, 0, 0, 0, 2, 43
"/Users/shiyu./Desktop/CP-Code/ZeroJudge/n130.cpp", "C++", 30, 0, 0, 2, 3, 35
"/Users/shiyu./Desktop/CP-Code/ZeroJudge/n369.cpp", "C++", 18, 0, 0, 0, 1, 19
"/Users/shiyu./Desktop/CP-Code/test-p.cpp", "C++", 20, 0, 0, 0, 2, 22
"/Users/shiyu./Desktop/CP-Code/test.cpp", "C++", 5, 0, 0, 0, 2, 7
"/Users/shiyu./Desktop/CP-Code/zz Func Template/DSU+.cpp", "C++", 25, 0, 0, 1, 4, 30
"/Users/shiyu./Desktop/CP-Code/zz Func Template/DSU.cpp", "C++", 26, 0, 0, 0, 3, 29
"/Users/shiyu./Desktop/CP-Code/zz Func Template/Fibonacci+.cpp", "C++", 22, 0, 0, 1, 2, 25
"/Users/shiyu./Desktop/CP-Code/zz Func Template/Fibonacci.cpp", "C++", 5, 0, 0, 1, 0, 6
"/Users/shiyu./Desktop/CP-Code/zz Func Template/GCD.cpp", "C++", 0, 0, 0, 0, 1, 1
"/Users/shiyu./Desktop/CP-Code/zz Func Template/NtoT.cpp", "C++", 11, 0, 0, 3, 3, 17
"/Users/shiyu./Desktop/CP-Code/zz Func Template/binary_search.cpp", "C++", 11, 0, 0, 1, 0, 12
"/Users/shiyu./Desktop/CP-Code/zz Func Template/factorial.cpp", "C++", 5, 0, 0, 1, 0, 6
"/Users/shiyu./Desktop/CP-Code/zz Func Template/fpow.cpp", "C++", 6, 0, 0, 12, 1, 19
"/Users/shiyu./Desktop/CP-Code/zz Func Template/int sqrt.cpp", "C++", 9, 0, 0, 0, 0, 9
"/Users/shiyu./Desktop/CP-Code/zz Func Template/is 2^n.cpp", "C++", 4, 0, 0, 0, 0, 4
"/Users/shiyu./Desktop/CP-Code/zz Func Template/jump_search.cpp", "C++", 10, 0, 0, 1, 0, 11
"/Users/shiyu./Desktop/CP-Code/zz Func Template/matrix.cpp", "C++", 9, 0, 0, 0, 0, 9
"/Users/shiyu./Desktop/CP-Code/zz Func Template/segment tree 2.cpp", "C++", 44, 0, 0, 0, 5, 49
"/Users/shiyu./Desktop/CP-Code/zz Func Template/segment tree(20240124).cpp", "C++", 43, 0, 0, 0, 5, 48
"/Users/shiyu./Desktop/CP-Code/zz Func Template/unique.cpp", "C++", 22, 0, 0, 1, 0, 23
"Total", "-", 24031, 674, 165, 1277, 2116, 28263